"A"	T
"AA"	T
"AAC"	T
"AACI"	F
"AADI"	F
"AAIC"	F
"AAL"	T
"AAN"	T
"AAOI"	T
"AAON"	F
"AAP"	T
"AAPL"	T
"AAQC"	F
"AAT"	T
"AATC"	F
"AAV"	T
"AAWW"	T
"AB"	T
"ABB"	T
"ABBV"	T
"ABC"	T
"ABCB"	F
"ABCL"	F
"ABCM"	F
"ABEO"	T
"ABEV"	T
"ABG"	T
"ABGI"	F
"ABIO"	F
"ABM"	F
"ABMD"	T
"ABNB"	F
"ABOS"	F
"ABR"	T
"ABSI"	F
"ABST"	F
"ABT"	T
"ABUS"	T
"ABX"	T
"ACA"	F
"ACAB"	F
"ACAD"	T
"ACAH"	F
"ACAQ"	F
"ACB"	F
"ACCD"	F
"ACCO"	T
"ACDC"	F
"ACEL"	F
"ACER"	F
"ACET"	T
"ACGL"	T
"ACHC"	T
"ACHL"	F
"ACHR"	F
"ACHV"	F
"ACI"	F
"ACII"	F
"ACIU"	F
"ACIW"	T
"ACLS"	T
"ACLX"	F
"ACM"	T
"ACMR"	F
"ACN"	T
"ACNB"	F
"ACNT"	F
"ACQR"	F
"ACRE"	T
"ACRO"	F
"ACRS"	F
"ACRV"	F
"ACRX"	T
"ACT"	F
"ACTG"	T
"ACVA"	F
"ACXP"	F
"ADAG"	F
"ADAL"	F
"ADAP"	T
"ADBE"	T
"ADC"	T
"ADCT"	F
"ADEA"	F
"ADER"	F
"ADES"	F
"ADEX"	F
"ADI"	T
"ADM"	T
"ADMA"	F
"ADN"	F
"ADNT"	T
"ADP"	T
"ADPT"	F
"ADRA"	F
"ADRNY"	F
"ADSK"	T
"ADT"	F
"ADTH"	F
"ADTN"	T
"ADTX"	F
"ADUS"	T
"ADV"	F
"AE"	F
"AEAC"	F
"AEAE"	F
"AEE"	T
"AEG"	T
"AEHA"	F
"AEHR"	F
"AEIS"	T
"AEL"	F
"AEM"	T
"AENZ"	F
"AEO"	T
"AEP"	T
"AER"	T
"AERC"	F
"AERG"	F
"AES"	T
"AESE"	F
"AEVA"	F
"AEY"	F
"AEYE"	F
"AFAC"	F
"AFAQ"	F
"AFCG"	F
"AFG"	F
"AFL"	T
"AFLYY"	F
"AFMD"	T
"AFRM"	F
"AFTR"	F
"AFYA"	F
"AGAC"	F
"AGBA"	F
"AGCB"	F
"AGCO"	T
"AGEN"	T
"AGFS"	T
"AGFY"	F
"AGGR"	F
"AGI"	T
"AGIL"	F
"AGIO"	T
"AGL"	F
"AGLE"	F
"AGM"	T
"AGNC"	T
"AGO"	T
"AGR"	F
"AGRI"	F
"AGRO"	T
"AGS"	F
"AGTI"	F
"AGX"	F
"AGYS"	F
"AHCO"	F
"AHH"	T
"AHPI"	F
"AHT"	T
"AI"	T
"AIB"	F
"AIG"	T
"AIKI"	F
"AIMC"	F
"AIN"	T
"AIP"	F
"AIR"	T
"AIRC"	F
"AIRG"	F
"AIRI"	F
"AIRS"	F
"AIT"	F
"AIU"	F
"AIV"	T
"AIZ"	T
"AJG"	T
"AJRD"	T
"AJX"	F
"AKA"	F
"AKAM"	T
"AKIC"	F
"AKLI"	F
"AKO.B"	F
"AKR"	F
"AKRO"	F
"AKTS"	F
"AKU"	F
"AKUS"	F
"AKYA"	F
"AKZOY"	F
"AL"	T
"ALB"	T
"ALBO"	F
"ALCC"	F
"ALCO"	F
"ALDX"	F
"ALE"	F
"ALEC"	F
"ALEX"	T
"ALG"	F
"ALGM"	F
"ALGN"	T
"ALGS"	F
"ALGT"	T
"ALHC"	F
"ALIM"	T
"ALIT"	F
"ALJJ"	F
"ALK"	T
"ALKS"	T
"ALKT"	F
"ALL"	T
"ALLE"	T
"ALLG"	F
"ALLK"	F
"ALLO"	F
"ALLT"	T
"ALLY"	T
"ALNY"	T
"ALPA"	F
"ALPN"	F
"ALRM"	T
"ALRN"	F
"ALRS"	F
"ALSN"	T
"ALT"	F
"ALTG"	F
"ALTO"	F
"ALTR"	F
"ALTU"	F
"ALV"	T
"ALVO"	F
"ALVR"	F
"ALXO"	F
"ALYA"	F
"ALZN"	F
"AM"	T
"AMAL"	F
"AMAO"	F
"AMAT"	T
"AMBA"	T
"AMBC"	T
"AMBP"	F
"AMC"	T
"AMCI"	F
"AMCR"	F
"AMCX"	T
"AMD"	T
"AME"	T
"AMED"	T
"AMEH"	F
"AMG"	T
"AMGN"	T
"AMH"	T
"AMK"	F
"AMKR"	T
"AMLX"	F
"AMN"	T
"AMNB"	F
"AMNF"	F
"AMOT"	T
"AMP"	T
"AMPG"	F
"AMPH"	F
"AMPI"	F
"AMPL"	F
"AMPS"	F
"AMPX"	F
"AMPY"	F
"AMR"	F
"AMRC"	T
"AMRK"	F
"AMRN"	T
"AMRS"	T
"AMRX"	F
"AMS"	F
"AMSC"	T
"AMSF"	F
"AMSWA"	F
"AMT"	T
"AMTB"	F
"AMTD"	T
"AMTX"	F
"AMV"	F
"AMWD"	T
"AMWL"	F
"AMX"	T
"AMYT"	F
"AMZN"	T
"AN"	T
"ANAB"	F
"ANAC"	F
"ANCTF"	F
"ANDE"	T
"ANET"	T
"ANF"	T
"ANGH"	F
"ANGI"	T
"ANGO"	F
"ANIK"	T
"ANIP"	T
"ANIX"	F
"ANNX"	F
"ANPC"	F
"ANSS"	T
"ANTX"	F
"ANVS"	F
"ANZBY"	F
"ANZU"	F
"AOMR"	F
"AON"	T
"AORT"	F
"AOS"	F
"AOSL"	T
"AOUT"	F
"AP"	T
"APA"	T
"APAM"	T
"APCA"	F
"APD"	T
"APDN"	T
"APEI"	T
"APEN"	F
"APG"	F
"APGB"	F
"APGN"	F
"APH"	T
"API"	F
"APLD"	F
"APLE"	F
"APLS"	F
"APMI"	F
"APO"	T
"APOG"	T
"APP"	F
"APPF"	F
"APPH"	F
"APPN"	F
"APPS"	T
"APRN"	F
"APT"	T
"APTM"	F
"APTV"	F
"APVO"	F
"APXI"	F
"APYX"	F
"AQN"	F
"AQUA"	F
"AR"	T
"ARAV"	F
"ARAY"	T
"ARBE"	F
"ARC"	T
"ARCB"	T
"ARCE"	F
"ARCH"	T
"ARCK"	F
"ARCO"	T
"ARCT"	F
"ARDX"	T
"ARE"	T
"AREC"	F
"AREN"	F
"ARES"	T
"ARGO"	F
"ARGU"	F
"ARGX"	F
"ARHS"	F
"ARI"	T
"ARIS"	F
"ARIZ"	F
"ARKO"	F
"ARLO"	F
"ARLP"	T
"ARMK"	T
"ARNC"	T
"AROC"	T
"AROW"	F
"ARQQ"	F
"ARQT"	F
"ARR"	T
"ARRY"	T
"ARTE"	F
"ARTL"	F
"ARTNA"	F
"ARVN"	F
"ARW"	T
"ARWR"	T
"ARYD"	F
"ARYE"	F
"ASAI"	F
"ASAN"	F
"ASAP"	F
"ASB"	T
"ASC"	T
"ASCB"	F
"ASGN"	T
"ASH"	T
"ASIX"	T
"ASLE"	F
"ASMB"	T
"ASMIY"	F
"ASML"	T
"ASND"	F
"ASO"	F
"ASPA"	F
"ASPI"	F
"ASPN"	F
"ASPS"	T
"ASR"	T
"ASRT"	F
"ASRV"	F
"ASTE"	T
"ASTI"	F
"ASTL"	F
"ASTS"	F
"ASUR"	F
"ASX"	T
"ASYS"	T
"AT"	T
"ATA"	F
"ATAI"	F
"ATAQ"	F
"ATAX"	F
"ATCO"	F
"ATCX"	F
"ATDS"	F
"ATEC"	F
"ATEK"	F
"ATEN"	T
"ATER"	F
"ATEX"	F
"ATEYY"	F
"ATGE"	F
"ATHA"	F
"ATHM"	T
"ATI"	T
"ATKR"	F
"ATLC"	T
"ATLO"	F
"ATNI"	T
"ATNM"	F
"ATO"	T
"ATOM"	F
"ATR"	T
"ATRA"	F
"ATRC"	F
"ATRO"	F
"ATSG"	T
"ATTO"	F
"ATUS"	F
"ATVI"	T
"ATXG"	F
"ATXI"	F
"ATXS"	F
"AU"	T
"AUB"	F
"AUDC"	T
"AUGX"	F
"AUOTY"	F
"AUPH"	T
"AUR"	F
"AURA"	F
"AURC"	F
"AUST"	F
"AUTL"	F
"AUUD"	F
"AUY"	T
"AVA"	T
"AVAL"	F
"AVAV"	T
"AVB"	T
"AVD"	T
"AVDL"	T
"AVDX"	F
"AVEO"	T
"AVGO"	T
"AVGR"	T
"AVHI"	T
"AVID"	T
"AVIR"	T
"AVNS"	F
"AVNT"	F
"AVNW"	F
"AVO"	F
"AVPT"	F
"AVT"	T
"AVTE"	F
"AVTR"	F
"AVTX"	F
"AVXL"	T
"AVY"	T
"AVYA"	F
"AWCMY"	F
"AWI"	T
"AWK"	T
"AWR"	T
"AWRE"	T
"AX"	F
"AXAC"	F
"AXAHY"	F
"AXAS"	T
"AXGN"	T
"AXL"	T
"AXNX"	F
"AXON"	T
"AXP"	T
"AXS"	T
"AXSM"	F
"AXTA"	T
"AXTI"	T
"AY"	F
"AYI"	T
"AYX"	F
"AZ"	F
"AZEK"	F
"AZN"	T
"AZO"	T
"AZPN"	T
"AZRE"	F
"AZTA"	F
"AZUL"	F
"AZZ"	T
"B"	T
"BA"	T
"BABA"	T
"BAC"	T
"BACA"	F
"BAH"	T
"BAK"	T
"BALL"	F
"BALY"	F
"BAM"	T
"BAM.A"	F
"BAMR"	F
"BANC"	T
"BAND"	F
"BANF"	F
"BANR"	T
"BAP"	T
"BARK"	F
"BASE"	F
"BASFY"	F
"BATL"	F
"BATRA"	F
"BAX"	T
"BAYRY"	F
"BB"	F
"BBAR"	F
"BBBY"	T
"BBCP"	F
"BBD"	T
"BBIO"	F
"BBSI"	T
"BBUC"	F
"BBVA"	T
"BBW"	T
"BBWI"	F
"BBY"	T
"BC"	T
"BCAB"	F
"BCBP"	F
"BCC"	T
"BCDA"	F
"BCE"	T
"BCEL"	F
"BCH"	F
"BCLI"	F
"BCML"	F
"BCO"	T
"BCOR"	T
"BCOV"	T
"BCPC"	T
"BCRX"	T
"BCS"	T
"BCSA"	F
"BCSF"	F
"BCT"	F
"BCYC"	F
"BDC"	T
"BDCO"	F
"BDN"	T
"BDSX"	F
"BDTX"	F
"BDX"	T
"BE"	F
"BEAM"	F
"BEAT"	T
"BECN"	T
"BEEM"	F
"BEKE"	F
"BEN"	T
"BEPC"	F
"BERY"	T
"BF.B"	F
"BFAC"	F
"BFAM"	T
"BFC"	F
"BFH"	F
"BFI"	F
"BFIN"	F
"BFLY"	F
"BFS"	F
"BFST"	F
"BG"	T
"BGCP"	T
"BGFV"	T
"BGI"	F
"BGNE"	F
"BGRY"	F
"BGS"	T
"BGSF"	F
"BGSX"	F
"BHAC"	F
"BHB"	F
"BHC"	F
"BHE"	T
"BHF"	F
"BHG"	F
"BHIL"	F
"BHLB"	F
"BHM"	F
"BHP"	T
"BHR"	F
"BIAF"	F
"BIDU"	T
"BIG"	T
"BIGC"	F
"BIGZ"	F
"BIIB"	T
"BILI"	F
"BILL"	F
"BIO"	T
"BIOS"	T
"BIOX"	F
"BIP"	T
"BIPC"	F
"BIRD"	F
"BITE"	F
"BIVI"	F
"BJ"	F
"BJRI"	T
"BK"	T
"BKD"	T
"BKE"	T
"BKH"	F
"BKI"	F
"BKKT"	F
"BKNG"	F
"BKR"	F
"BKSY"	F
"BKTI"	F
"BKU"	T
"BKYI"	F
"BL"	F
"BLBD"	F
"BLCO"	F
"BLD"	T
"BLDE"	F
"BLDP"	T
"BLDR"	T
"BLEU"	F
"BLFS"	F
"BLFY"	F
"BLI"	F
"BLIN"	F
"BLK"	T
"BLKB"	T
"BLMN"	T
"BLND"	F
"BLNG"	F
"BLNK"	F
"BLTE"	F
"BLTS"	F
"BLU"	F
"BLUA"	F
"BLUE"	T
"BLX"	F
"BLZE"	F
"BMA"	T
"BMAC"	F
"BMBL"	F
"BMEA"	F
"BMI"	T
"BMNM"	F
"BMO"	T
"BMRA"	F
"BMRC"	F
"BMRN"	T
"BMTX"	F
"BMY"	T
"BNED"	F
"BNFT"	T
"BNGO"	F
"BNL"	F
"BNNLF"	F
"BNNR"	F
"BNR"	F
"BNS"	T
"BNSO"	F
"BNTX"	F
"BOC"	F
"BOH"	F
"BOKF"	T
"BOLT"	F
"BON"	F
"BOOM"	T
"BOOT"	T
"BOWL"	F
"BOX"	T
"BP"	T
"BPAC"	F
"BPMC"	T
"BPOP"	T
"BPT"	T
"BPTH"	F
"BPYPP"	F
"BQ"	F
"BR"	T
"BRAG"	F
"BRBR"	F
"BRBS"	F
"BRC"	T
"BRCC"	F
"BRD"	F
"BRDCY"	F
"BRDG"	F
"BRFH"	F
"BRFS"	T
"BRIV"	F
"BRKH"	F
"BRKL"	T
"BRKR"	T
"BRLT"	F
"BRMK"	F
"BRN"	F
"BRO"	T
"BROS"	F
"BRP"	F
"BRSP"	F
"BRT"	F
"BRX"	F
"BRY"	F
"BRZE"	F
"BSAC"	T
"BSBK"	F
"BSBR"	T
"BSET"	T
"BSFO"	F
"BSGA"	F
"BSIG"	F
"BSKY"	F
"BSM"	T
"BSQR"	T
"BSRR"	T
"BSX"	T
"BSY"	F
"BTAI"	F
"BTCY"	F
"BTE"	T
"BTI"	T
"BTMD"	F
"BTN"	T
"BTO"	F
"BTRS"	F
"BTTX"	F
"BTU"	T
"BTWN"	F
"BUD"	T
"BURL"	T
"BUSE"	F
"BV"	T
"BVH"	F
"BVN"	T
"BVS"	F
"BW"	F
"BWA"	T
"BWB"	F
"BWEN"	F
"BWFG"	F
"BWMN"	F
"BWMX"	F
"BWV"	F
"BWXT"	T
"BX"	T
"BXC"	F
"BXMT"	T
"BXP"	T
"BXSL"	F
"BY"	F
"BYD"	T
"BYFC"	F
"BYN"	F
"BYND"	F
"BYRN"	F
"BZ"	F
"BZFD"	F
"BZH"	T
"BZLFY"	F
"BZUN"	T
"C"	T
"CAAP"	F
"CAAS"	T
"CABA"	F
"CABGY"	F
"CABO"	F
"CAC"	F
"CACC"	F
"CACI"	T
"CADE"	F
"CADL"	F
"CAE"	F
"CAG"	T
"CAH"	T
"CAJ"	T
"CAKE"	T
"CAL"	T
"CALA"	T
"CALB"	F
"CALM"	T
"CALX"	T
"CAMP"	T
"CAMT"	T
"CAN"	F
"CANG"	F
"CANO"	F
"CAPL"	T
"CAPR"	F
"CAR"	T
"CARA"	T
"CARG"	F
"CARR"	F
"CARS"	F
"CARV"	F
"CASA"	F
"CASH"	F
"CASI"	F
"CASS"	F
"CASY"	F
"CAT"	T
"CATC"	F
"CATO"	F
"CATY"	F
"CB"	T
"CBAN"	F
"CBAT"	F
"CBAY"	F
"CBD"	T
"CBL"	T
"CBNK"	F
"CBOE"	T
"CBRE"	F
"CBRG"	F
"CBRL"	T
"CBSH"	T
"CBT"	F
"CBU"	T
"CBZ"	F
"CC"	T
"CCB"	F
"CCBG"	F
"CCCC"	F
"CCCS"	F
"CCEP"	F
"CCF"	F
"CCI"	T
"CCJ"	T
"CCK"	T
"CCL"	T
"CCLP"	T
"CCNC"	F
"CCNE"	F
"CCO"	T
"CCOI"	T
"CCRD"	F
"CCRN"	T
"CCS"	F
"CCSI"	F
"CCU"	F
"CCV"	F
"CCVI"	F
"CD"	F
"CDAY"	F
"CDE"	T
"CDIO"	F
"CDLX"	F
"CDMO"	F
"CDNA"	F
"CDNS"	T
"CDRE"	F
"CDRO"	F
"CDW"	T
"CDXC"	T
"CDXS"	F
"CDZI"	T
"CE"	T
"CECO"	T
"CEG"	F
"CEIX"	F
"CELC"	F
"CELH"	F
"CELU"	F
"CENQ"	F
"CENT"	F
"CENX"	T
"CEQP"	T
"CERE"	F
"CERS"	T
"CERT"	F
"CEVA"	T
"CF"	T
"CFB"	F
"CFFE"	F
"CFFN"	T
"CFG"	T
"CFIV"	F
"CFLT"	F
"CFMS"	F
"CFR"	T
"CG"	T
"CGBD"	F
"CGEM"	F
"CGNT"	F
"CGNX"	T
"CGRN"	F
"CGTX"	F
"CHAA"	F
"CHCO"	F
"CHCT"	F
"CHD"	T
"CHDN"	T
"CHE"	T
"CHEF"	F
"CHGG"	T
"CHH"	T
"CHK"	T
"CHKP"	T
"CHKR"	T
"CHMI"	F
"CHPT"	F
"CHRA"	F
"CHRD"	F
"CHRS"	F
"CHRW"	T
"CHS"	T
"CHSCP"	F
"CHTR"	T
"CHUY"	T
"CHWY"	F
"CHX"	F
"CI"	T
"CIA"	T
"CIB"	F
"CIEN"	T
"CIG"	T
"CIGI"	F
"CIIG"	F
"CIM"	T
"CINC"	F
"CINF"	T
"CINT"	F
"CIO"	T
"CION"	F
"CIR"	T
"CISO"	F
"CITE"	F
"CIVB"	F
"CIVI"	F
"CJR.B"	F
"CJREF"	F
"CL"	T
"CLAA"	F
"CLAR"	F
"CLAS"	F
"CLB"	T
"CLBK"	F
"CLBR"	F
"CLBT"	F
"CLDT"	T
"CLDX"	T
"CLEU"	F
"CLF"	T
"CLFD"	T
"CLGN"	F
"CLH"	T
"CLIM"	F
"CLIN"	F
"CLLS"	T
"CLMT"	T
"CLNE"	T
"CLNN"	F
"CLOV"	F
"CLOW"	F
"CLPHY"	F
"CLPR"	F
"CLPS"	F
"CLPT"	F
"CLRB"	F
"CLRM"	F
"CLS"	T
"CLSD"	F
"CLSK"	F
"CLVT"	F
"CLW"	F
"CLWT"	F
"CLX"	T
"CM"	T
"CMA"	T
"CMAX"	F
"CMBM"	F
"CMC"	T
"CMCL"	F
"CMCM"	T
"CMCO"	T
"CMCSA"	T
"CME"	T
"CMG"	T
"CMI"	T
"CMLS"	T
"CMMB"	F
"CMND"	F
"CMP"	T
"CMPO"	F
"CMPR"	T
"CMPS"	F
"CMPX"	F
"CMRA"	F
"CMRE"	T
"CMRX"	T
"CMS"	T
"CMT"	F
"CMTG"	F
"CMTL"	T
"CNA"	F
"CNC"	T
"CNCE"	T
"CND"	F
"CNDA"	F
"CNDT"	T
"CNF"	F
"CNGL"	F
"CNHI"	T
"CNI"	T
"CNK"	T
"CNM"	F
"CNMD"	T
"CNNE"	F
"CNO"	T
"CNOB"	F
"CNP"	T
"CNQ"	T
"CNR"	F
"CNS"	F
"CNSL"	T
"CNTA"	F
"CNTX"	F
"CNTY"	T
"CNX"	T
"CNXC"	F
"CNXN"	F
"CO"	F
"COCO"	F
"COCP"	F
"CODI"	T
"CODX"	F
"COE"	F
"COEP"	F
"COF"	T
"COFS"	F
"COGT"	T
"COHN"	F
"COHR"	T
"COHU"	T
"COIN"	F
"COKE"	F
"COLB"	F
"COLD"	F
"COLI"	F
"COLL"	T
"COLM"	T
"COMM"	T
"COMP"	F
"CONN"	T
"COO"	T
"COOK"	F
"COOL"	F
"COOP"	F
"COP"	T
"CORR"	T
"CORS"	F
"CORT"	T
"COST"	T
"COTY"	T
"COUP"	T
"COUR"	F
"COVA"	F
"COWN"	T
"CP"	T
"CPA"	T
"CPAA"	F
"CPAC"	F
"CPAR"	F
"CPB"	T
"CPE"	T
"CPF"	T
"CPG"	T
"CPIX"	T
"CPK"	F
"CPLP"	T
"CPNG"	F
"CPRI"	F
"CPRT"	T
"CPRX"	T
"CPS"	T
"CPSH"	F
"CPSI"	T
"CPSS"	T
"CPT"	T
"CPTK"	F
"CPTN"	F
"CPUH"	F
"CR"	F
"CRAI"	T
"CRBU"	F
"CRC"	T
"CRCT"	F
"CRDF"	F
"CRDO"	F
"CREC"	F
"CRESY"	T
"CRGE"	F
"CRGY"	F
"CRH"	T
"CRI"	T
"CRK"	T
"CRL"	T
"CRM"	T
"CRMD"	T
"CRMT"	T
"CRNC"	F
"CRNT"	T
"CRNX"	F
"CRON"	F
"CROX"	T
"CRRCF"	F
"CRS"	T
"CRSP"	F
"CRSR"	F
"CRT"	F
"CRTD"	F
"CRTO"	T
"CRU"	F
"CRUS"	T
"CRVL"	F
"CRWD"	F
"CRWS"	F
"CRZBY"	F
"CRZN"	F
"CS"	T
"CSAN"	F
"CSBR"	F
"CSCO"	T
"CSGP"	F
"CSGS"	T
"CSII"	T
"CSIQ"	T
"CSL"	F
"CSLM"	F
"CSR"	F
"CSSE"	F
"CSTA"	F
"CSTE"	T
"CSTL"	F
"CSTM"	T
"CSTR"	F
"CSV"	T
"CSWC"	F
"CSWI"	F
"CSX"	T
"CTAQ"	F
"CTAS"	T
"CTBI"	F
"CTG"	T
"CTIC"	T
"CTKB"	F
"CTLP"	F
"CTLT"	T
"CTMX"	F
"CTO"	F
"CTOS"	F
"CTRA"	F
"CTRE"	T
"CTRM"	F
"CTRN"	T
"CTS"	T
"CTSH"	T
"CTSO"	T
"CTTAY"	F
"CTV"	F
"CTVA"	F
"CTXR"	F
"CUBE"	T
"CUBI"	F
"CUE"	F
"CUK"	F
"CULP"	F
"CURI"	F
"CURO"	F
"CURV"	F
"CUTR"	T
"CUZ"	F
"CVAC"	F
"CVBF"	T
"CVCO"	F
"CVCY"	F
"CVE"	T
"CVEO"	T
"CVGI"	F
"CVGW"	T
"CVI"	T
"CVII"	F
"CVLG"	F
"CVLT"	T
"CVLY"	F
"CVM"	F
"CVNA"	F
"CVRX"	F
"CVS"	T
"CVT"	F
"CVU"	F
"CVV"	F
"CVX"	T
"CW"	T
"CWAN"	F
"CWBR"	F
"CWCO"	T
"CWEN.A"	F
"CWGL"	F
"CWH"	T
"CWK"	F
"CWST"	T
"CWT"	T
"CX"	T
"CXDO"	F
"CXM"	F
"CXW"	T
"CYAN"	F
"CYBR"	T
"CYD"	T
"CYH"	T
"CYRX"	F
"CYT"	F
"CYTH"	F
"CYTK"	T
"CYTO"	F
"CYXT"	F
"CZNC"	F
"CZR"	T
"CZWI"	F
"D"	T
"DAC"	F
"DADA"	F
"DAIO"	F
"DAKT"	T
"DAL"	T
"DALN"	F
"DAN"	T
"DANOY"	F
"DAO"	F
"DAOO"	F
"DAR"	T
"DASH"	F
"DASTY"	F
"DAVA"	F
"DAWN"	F
"DB"	T
"DBD"	T
"DBGI"	F
"DBI"	F
"DBRG"	F
"DBTX"	F
"DBVT"	F
"DBX"	F
"DC"	F
"DCBO"	F
"DCFC"	F
"DCGO"	F
"DCI"	T
"DCO"	T
"DCOM"	F
"DCP"	T
"DCPH"	F
"DCRD"	F
"DCT"	F
"DCTH"	F
"DD"	T
"DDD"	T
"DDL"	F
"DDOG"	F
"DDS"	T
"DE"	T
"DEA"	T
"DECK"	T
"DEI"	T
"DELL"	F
"DEN"	F
"DENN"	T
"DEO"	T
"DERM"	F
"DESP"	F
"DFFN"	F
"DFH"	F
"DFIN"	T
"DFLI"	F
"DFS"	T
"DG"	T
"DGICA"	F
"DGII"	F
"DGNU"	F
"DGX"	T
"DH"	F
"DHBC"	F
"DHC"	F
"DHCA"	F
"DHHC"	F
"DHI"	T
"DHIL"	F
"DHR"	T
"DHT"	T
"DHX"	T
"DIBS"	F
"DICE"	F
"DIDIY"	F
"DIIBF"	F
"DIN"	T
"DINO"	F
"DIOD"	T
"DIS"	T
"DISH"	T
"DK"	T
"DKDCA"	F
"DKL"	T
"DKNG"	F
"DKS"	T
"DLA"	F
"DLAKY"	F
"DLB"	T
"DLCA"	F
"DLHC"	F
"DLNG"	T
"DLO"	F
"DLPN"	F
"DLR"	T
"DLTH"	F
"DLTR"	T
"DLX"	T
"DM"	T
"DMAC"	F
"DMAQ"	F
"DML"	F
"DMLP"	F
"DMRC"	F
"DMS"	F
"DMTK"	F
"DMYS"	F
"DNA"	F
"DNAB"	F
"DNAD"	F
"DNAY"	F
"DNB"	T
"DNLI"	F
"DNMR"	F
"DNN"	T
"DNOW"	T
"DNUT"	F
"DNZ"	F
"DO"	T
"DOC"	T
"DOCN"	F
"DOCS"	F
"DOCU"	F
"DOLE"	F
"DOMO"	F
"DOO"	F
"DOOR"	F
"DORM"	T
"DOUG"	F
"DOV"	T
"DOW"	T
"DOX"	T
"DOYU"	F
"DPCS"	F
"DPRO"	F
"DPSI"	F
"DPZ"	T
"DQ"	T
"DRCT"	F
"DRD"	T
"DRH"	T
"DRI"	T
"DRIO"	F
"DRQ"	T
"DRVN"	F
"DSAQ"	F
"DSEY"	F
"DSG"	F
"DSGN"	F
"DSGR"	F
"DSGX"	F
"DSKE"	F
"DSP"	F
"DSX"	T
"DT"	F
"DTC"	F
"DTE"	T
"DTEGY"	F
"DTIL"	F
"DTM"	F
"DTOC"	F
"DTRT"	F
"DTSS"	F
"DTST"	F
"DUK"	T
"DUO"	F
"DUOL"	F
"DUOT"	F
"DV"	T
"DVA"	T
"DVAX"	T
"DVN"	T
"DWAC"	F
"DX"	T
"DXC"	T
"DXCM"	T
"DXLG"	T
"DXPE"	T
"DY"	T
"DYAI"	F
"DYN"	T
"DYNR"	F
"DZSI"	T
"E"	T
"EA"	T
"EAC"	F
"EAF"	F
"EARN"	F
"EAT"	T
"EB"	F
"EBAC"	F
"EBAY"	T
"EBC"	F
"EBF"	F
"EBIX"	T
"EBON"	F
"EBS"	T
"EBTC"	F
"EC"	T
"ECAT"	F
"ECBK"	F
"ECL"	T
"ECPG"	T
"ECTM"	F
"ECVT"	F
"ED"	T
"EDAP"	T
"EDIT"	T
"EDN"	F
"EDR"	T
"EDRY"	F
"EDU"	T
"EDUC"	F
"EE"	T
"EEFT"	F
"EEIQ"	F
"EEX"	F
"EFC"	T
"EFR"	F
"EFSC"	F
"EFSH"	F
"EFX"	F
"EGAN"	T
"EGBN"	T
"EGHT"	T
"EGIO"	F
"EGLE"	F
"EGO"	T
"EGP"	F
"EGRX"	T
"EGY"	T
"EH"	F
"EHAB"	F
"EHC"	F
"EHTH"	T
"EIG"	F
"EIGR"	F
"EIX"	T
"EKSO"	F
"EL"	T
"ELA"	F
"ELAN"	F
"ELBM"	F
"ELD"	T
"ELDN"	F
"ELEV"	F
"ELF"	T
"ELMD"	F
"ELME"	F
"ELP"	T
"ELS"	F
"ELV"	F
"ELVT"	F
"EMBC"	F
"EMBK"	F
"EME"	F
"EMF"	F
"EMKR"	T
"EMLD"	F
"EMN"	T
"EMR"	T
"EMX"	F
"ENB"	T
"ENCP"	F
"ENER"	F
"ENFN"	F
"ENIC"	F
"ENLC"	T
"ENLV"	F
"ENOB"	F
"ENOV"	F
"ENPH"	T
"ENR"	T
"ENS"	T
"ENSC"	F
"ENSG"	F
"ENSV"	F
"ENTA"	F
"ENTF"	F
"ENTG"	T
"ENV"	F
"ENVA"	T
"ENVB"	F
"ENVX"	F
"ENZ"	T
"EOCW"	F
"EOG"	T
"EOLS"	F
"EONGY"	F
"EOSE"	F
"EP"	F
"EPAC"	F
"EPAM"	T
"EPC"	T
"EPD"	T
"EPHY"	F
"EPIX"	F
"EPM"	T
"EPOW"	F
"EPR"	T
"EPRT"	F
"EPSN"	F
"EPWR"	F
"EQ"	F
"EQBK"	F
"EQC"	T
"EQH"	F
"EQHA"	F
"EQIX"	T
"EQNR"	F
"EQR"	T
"EQRX"	F
"EQT"	T
"EQX"	F
"ERAS"	F
"ERES"	F
"ERF"	T
"ERIC"	T
"ERIE"	F
"ERII"	T
"ERJ"	T
"ERNA"	F
"ERO"	F
"ES"	T
"ESAB"	F
"ESAC"	F
"ESALY"	F
"ESCA"	F
"ESE"	T
"ESEA"	F
"ESGR"	F
"ESI"	F
"ESLT"	F
"ESM"	F
"ESMT"	F
"ESNT"	T
"ESOA"	F
"ESPR"	T
"ESQ"	F
"ESRT"	T
"ESS"	T
"ESTA"	F
"ESTC"	F
"ESTE"	F
"ET"	F
"ETCG"	F
"ETD"	F
"ETHE"	F
"ETN"	T
"ETNB"	F
"ETON"	F
"ETR"	T
"ETRN"	F
"ETSY"	T
"ETWO"	F
"EUDA"	F
"EVA"	T
"EVAX"	F
"EVBG"	T
"EVBN"	F
"EVC"	T
"EVCM"	F
"EVE"	F
"EVER"	T
"EVEX"	F
"EVGO"	F
"EVH"	F
"EVI"	F
"EVLO"	F
"EVLV"	T
"EVOJ"	F
"EVOK"	F
"EVOP"	F
"EVR"	T
"EVRG"	F
"EVRI"	T
"EVTC"	T
"EVTL"	F
"EVTV"	F
"EW"	T
"EWBC"	T
"EWCZ"	F
"EWTX"	F
"EXAI"	F
"EXAS"	T
"EXC"	T
"EXEL"	T
"EXFY"	F
"EXK"	T
"EXLS"	T
"EXP"	T
"EXPD"	T
"EXPE"	T
"EXPI"	F
"EXPO"	F
"EXPR"	T
"EXR"	T
"EXTR"	T
"EYE"	F
"EYEN"	F
"EYPT"	F
"EZPW"	T
"F"	T
"FA"	F
"FACA"	F
"FACT"	F
"FAF"	T
"FANG"	T
"FANH"	T
"FARM"	F
"FARO"	T
"FAST"	T
"FAT"	F
"FATE"	F
"FATH"	F
"FATP"	F
"FAZE"	F
"FBC"	T
"FBHS"	T
"FBIZ"	F
"FBK"	F
"FBMS"	F
"FBNC"	F
"FBP"	T
"FBRT"	F
"FBRX"	F
"FC"	F
"FCAX"	F
"FCBC"	T
"FCCO"	F
"FCEL"	T
"FCF"	T
"FCFS"	T
"FCN"	T
"FCNCA"	F
"FCPT"	F
"FCRD"	F
"FCUV"	F
"FCX"	T
"FDMT"	F
"FDP"	T
"FDS"	T
"FDX"	T
"FE"	T
"FEAM"	F
"FELE"	F
"FEMY"	F
"FENC"	F
"FENG"	T
"FERG"	F
"FET"	T
"FEXD"	F
"FF"	T
"FFBC"	F
"FFIC"	F
"FFIN"	F
"FFIV"	T
"FFWM"	F
"FGEN"	T
"FGI"	F
"FHB"	T
"FHI"	F
"FHN"	T
"FHTX"	F
"FIBK"	F
"FICO"	T
"FIGS"	F
"FINV"	F
"FINW"	F
"FIP"	F
"FIS"	T
"FISI"	F
"FISV"	T
"FITB"	T
"FIVE"	T
"FIVN"	T
"FIX"	T
"FIXX"	F
"FIZZ"	T
"FJTSY"	F
"FL"	T
"FLAG"	F
"FLEX"	T
"FLGT"	F
"FLIC"	F
"FLL"	F
"FLME"	F
"FLNC"	F
"FLNT"	F
"FLO"	T
"FLR"	T
"FLS"	T
"FLT"	T
"FLUX"	F
"FLWS"	T
"FLXS"	F
"FLYA"	F
"FLYW"	F
"FMAO"	F
"FMBH"	F
"FMC"	T
"FMIV"	F
"FMNB"	F
"FMX"	T
"FN"	T
"FNA"	F
"FNB"	F
"FND"	F
"FNF"	T
"FNGR"	F
"FNKO"	F
"FNV"	T
"FNVT"	F
"FOA"	F
"FOCS"	F
"FOLD"	T
"FONR"	F
"FOR"	T
"FORA"	F
"FORD"	F
"FORG"	F
"FORM"	T
"FORR"	T
"FOSL"	T
"FOUR"	F
"FOXA"	T
"FOXF"	F
"FPAC"	F
"FPAFY"	F
"FPAY"	F
"FPH"	F
"FPI"	T
"FR"	F
"FRBA"	F
"FRBK"	F
"FRBN"	F
"FRC"	F
"FRD"	F
"FREE"	F
"FREQ"	F
"FREY"	F
"FRG"	F
"FRGE"	F
"FRGI"	T
"FRHC"	F
"FRLA"	F
"FRME"	F
"FRO"	T
"FROG"	F
"FRON"	F
"FRPH"	F
"FRPT"	T
"FRSG"	F
"FRSH"	T
"FRST"	F
"FRT"	T
"FRTX"	F
"FRW"	F
"FRX"	F
"FRXB"	F
"FRZA"	F
"FSBC"	F
"FSBW"	F
"FSI"	F
"FSLR"	T
"FSLY"	F
"FSNB"	F
"FSP"	F
"FSR"	F
"FSRL"	F
"FSRX"	F
"FSS"	T
"FSSI"	F
"FSTR"	T
"FSTX"	F
"FSV"	F
"FTAI"	T
"FTCH"	F
"FTCI"	F
"FTCO"	F
"FTCV"	F
"FTDR"	F
"FTEK"	T
"FTEV"	F
"FTHM"	F
"FTI"	F
"FTK"	T
"FTNT"	T
"FTPA"	F
"FTS"	T
"FTV"	F
"FTVI"	F
"FUBO"	F
"FUJIY"	F
"FUL"	T
"FULC"	F
"FULT"	F
"FUN"	T
"FUSN"	F
"FUTU"	F
"FVCB"	F
"FVI"	F
"FVRR"	F
"FWAC"	F
"FWONA"	T
"FWRD"	F
"FWRG"	F
"FXLV"	F
"FYBR"	F
"FZT"	F
"G"	T
"GABC"	F
"GACQ"	F
"GAIA"	F
"GALT"	T
"GAMB"	F
"GAMC"	F
"GAMI"	F
"GAN"	F
"GANX"	F
"GAPA"	F
"GASS"	T
"GATE"	F
"GATX"	T
"GBCI"	T
"GBDC"	F
"GBIO"	F
"GBR"	F
"GBRG"	F
"GBTC"	F
"GBTG"	F
"GBX"	T
"GCBC"	F
"GCEH"	F
"GCI"	T
"GCMG"	F
"GCO"	T
"GCT"	F
"GD"	T
"GDDY"	T
"GDEN"	F
"GDLC"	F
"GDNR"	F
"GDOT"	T
"GDRX"	F
"GDS"	F
"GDYN"	F
"GE"	T
"GEF"	T
"GEG"	F
"GEL"	T
"GEN"	T
"GENC"	F
"GENE"	F
"GENI"	F
"GENQ"	F
"GEO"	T
"GEOS"	T
"GERN"	T
"GES"	T
"GET"	F
"GETY"	F
"GEVO"	T
"GFF"	T
"GFGD"	F
"GFI"	T
"GFL"	F
"GFOR"	F
"GFP"	F
"GFS"	F
"GFX"	F
"GGAL"	T
"GGB"	T
"GGE"	F
"GGG"	F
"GGMC"	F
"GGR"	F
"GH"	F
"GHAC"	F
"GHC"	F
"GHG"	F
"GHL"	T
"GHLD"	F
"GHM"	F
"GHRS"	F
"GIB"	T
"GIB.A"	F
"GIC"	F
"GIFI"	T
"GIII"	T
"GIIX"	F
"GIL"	T
"GILD"	T
"GILT"	F
"GIM"	F
"GIS"	T
"GKOS"	T
"GL"	F
"GLBE"	F
"GLBL"	T
"GLBS"	F
"GLDD"	T
"GLG"	F
"GLHA"	F
"GLLI"	F
"GLNG"	T
"GLOB"	F
"GLOP"	T
"GLP"	T
"GLPI"	T
"GLRE"	T
"GLSI"	F
"GLT"	T
"GLTA"	F
"GLTO"	F
"GLUE"	F
"GLW"	T
"GLXZ"	F
"GLYC"	F
"GM"	T
"GMAB"	F
"GMDA"	F
"GME"	T
"GMED"	T
"GMGI"	F
"GMRE"	F
"GMS"	F
"GMTX"	F
"GNAC"	F
"GNE"	F
"GNFT"	F
"GNK"	F
"GNL"	F
"GNPX"	F
"GNRC"	T
"GNSS"	F
"GNTX"	T
"GNTY"	F
"GNW"	T
"GO"	F
"GOCO"	F
"GOEV"	F
"GOGL"	T
"GOGN"	F
"GOGO"	T
"GOL"	F
"GOLD"	T
"GOLF"	T
"GOOD"	T
"GOOGL"	T
"GOOS"	T
"GORO"	T
"GOSS"	F
"GOTU"	F
"GPAC"	F
"GPC"	T
"GPI"	T
"GPK"	T
"GPMT"	F
"GPN"	T
"GPOR"	T
"GPP"	F
"GPRE"	T
"GPRK"	F
"GPRO"	T
"GPS"	T
"GPV"	F
"GRAB"	F
"GRBK"	T
"GRC"	T
"GRCL"	F
"GRFS"	T
"GRIN"	F
"GRMN"	T
"GRNA"	F
"GRND"	F
"GRNQ"	F
"GRNT"	F
"GROW"	T
"GROY"	F
"GRPH"	F
"GRPN"	T
"GRTS"	F
"GRTX"	F
"GRVY"	F
"GRWG"	F
"GS"	T
"GSAT"	T
"GSBC"	F
"GSBD"	F
"GSD"	F
"GSEV"	F
"GSHD"	F
"GSIT"	F
"GSK"	T
"GSL"	T
"GSM"	T
"GSMG"	F
"GSQD"	F
"GT"	T
"GTAC"	F
"GTBP"	F
"GTE"	T
"GTEC"	F
"GTES"	F
"GTHX"	F
"GTII"	F
"GTIM"	F
"GTLB"	F
"GTLS"	T
"GTN"	T
"GTPA"	F
"GTPB"	F
"GTX"	F
"GTY"	T
"GURE"	F
"GVA"	T
"GVCI"	F
"GWAV"	F
"GWH"	F
"GWRE"	T
"GWRS"	F
"GWSO"	F
"GWW"	T
"GXII"	F
"GXO"	F
"H"	T
"HA"	T
"HAE"	T
"HAFC"	T
"HAIA"	F
"HAIN"	T
"HAL"	T
"HALO"	T
"HAS"	T
"HASI"	T
"HAYN"	F
"HAYW"	F
"HBAN"	T
"HBB"	F
"HBI"	T
"HBIO"	T
"HBM"	T
"HBNC"	F
"HBT"	F
"HCA"	T
"HCAR"	F
"HCAT"	F
"HCC"	F
"HCCI"	F
"HCI"	T
"HCIC"	F
"HCII"	F
"HCKT"	T
"HCM"	F
"HCMA"	F
"HCMLY"	F
"HCNE"	F
"HCP"	T
"HCSG"	F
"HCVI"	F
"HCWB"	F
"HD"	T
"HDB"	T
"HDSN"	T
"HE"	F
"HEAR"	F
"HEES"	T
"HEI"	T
"HEINY"	F
"HELE"	T
"HEP"	T
"HERA"	F
"HES"	T
"HESM"	F
"HFWA"	F
"HGBL"	F
"HGTXU"	F
"HGTY"	F
"HGV"	T
"HHC"	T
"HHGC"	F
"HHLA"	F
"HHS"	T
"HI"	T
"HIBB"	T
"HIG"	T
"HII"	T
"HIII"	F
"HIL"	T
"HIMS"	F
"HIMX"	T
"HIPO"	F
"HITI"	F
"HIVE"	T
"HIW"	T
"HL"	T
"HLAH"	F
"HLF"	T
"HLGN"	F
"HLI"	F
"HLIO"	F
"HLIT"	T
"HLLY"	F
"HLMN"	F
"HLN"	F
"HLNE"	F
"HLT"	T
"HLTH"	T
"HLVX"	F
"HLX"	T
"HMA"	F
"HMC"	T
"HMCO"	F
"HMN"	F
"HMPT"	F
"HMST"	F
"HMY"	T
"HNI"	F
"HNRG"	F
"HNST"	F
"HOFT"	F
"HOG"	T
"HOLI"	T
"HOLO"	F
"HOLX"	T
"HOMB"	T
"HON"	T
"HONE"	F
"HOOD"	F
"HOOK"	F
"HOPE"	F
"HOTH"	F
"HOUR"	F
"HOUS"	F
"HOV"	T
"HOWL"	F
"HP"	T
"HPE"	T
"HPK"	F
"HPLT"	F
"HPP"	F
"HPQ"	T
"HQY"	T
"HR"	T
"HRB"	T
"HRBR"	F
"HRI"	T
"HRL"	T
"HRMY"	F
"HROW"	F
"HRT"	F
"HRTG"	T
"HRTX"	T
"HSAQ"	F
"HSBC"	T
"HSC"	T
"HSCS"	F
"HSIC"	T
"HSII"	T
"HSKA"	F
"HSON"	F
"HST"	T
"HSTM"	T
"HSTO"	F
"HSY"	T
"HT"	T
"HTBI"	F
"HTBK"	F
"HTCR"	F
"HTGC"	F
"HTH"	T
"HTHIY"	F
"HTHT"	T
"HTLD"	T
"HTLF"	F
"HTPA"	F
"HTZ"	T
"HUBB"	F
"HUBG"	T
"HUBS"	T
"HUDI"	F
"HUGS"	F
"HUM"	T
"HUMA"	F
"HUN"	T
"HURN"	T
"HUSA"	F
"HUT"	F
"HUYA"	F
"HVT"	F
"HWC"	F
"HWEL"	F
"HWKN"	F
"HWKZ"	F
"HWM"	F
"HXL"	T
"HY"	T
"HYFM"	F
"HYLN"	F
"HYSNY"	F
"HYW"	F
"HYZN"	F
"HZNP"	T
"HZO"	T
"HZON"	F
"IAA"	F
"IAC"	T
"IAG"	T
"IART"	T
"IAS"	F
"IAU"	T
"IBCP"	T
"IBER"	F
"IBEX"	F
"IBIO"	F
"IBKR"	T
"IBM"	T
"IBN"	T
"IBOC"	F
"IBP"	T
"IBRX"	F
"IBTX"	F
"ICAD"	T
"ICCC"	F
"ICD"	F
"ICE"	T
"ICFI"	F
"ICHR"	F
"ICLK"	F
"ICLR"	F
"ICNC"	F
"ICPT"	T
"ICU"	F
"ICUI"	F
"ICVX"	F
"IDA"	F
"IDCC"	T
"IDN"	F
"IDR"	F
"IDW"	F
"IDXX"	T
"IDYA"	F
"IE"	F
"IEP"	T
"IESC"	F
"IEX"	T
"IFF"	T
"IFIN"	F
"IFNNY"	F
"IFRX"	F
"IFS"	F
"IGIC"	F
"IGMS"	F
"IGT"	T
"IH"	F
"IHG"	F
"IHRT"	F
"IHS"	F
"III"	F
"IIII"	F
"IIIN"	T
"IIIV"	F
"IINN"	F
"IIPR"	F
"IKNA"	F
"ILAG"	F
"ILMN"	T
"ILPT"	F
"IMAB"	F
"IMAQ"	F
"IMAX"	T
"IMBBY"	F
"IMCC"	F
"IMCR"	F
"IMG"	F
"IMGN"	T
"IMGO"	F
"IMKTA"	T
"IMMR"	T
"IMMX"	F
"IMNM"	F
"IMNN"	F
"IMO"	T
"IMOS"	T
"IMPL"	F
"IMRA"	F
"IMRX"	F
"IMTX"	F
"IMUX"	F
"IMVT"	F
"IMXI"	F
"INAB"	F
"INAQ"	F
"INBK"	F
"INBX"	F
"INCR.U"	F
"INCY"	T
"INDB"	F
"INDI"	F
"INDO"	F
"INDT"	F
"INFA"	F
"INFN"	T
"INFU"	F
"INFY"	T
"ING"	T
"INGN"	T
"INGR"	T
"INKT"	F
"INM"	F
"INMB"	F
"INMD"	F
"INN"	T
"INNV"	F
"INO"	T
"INOD"	T
"INPX"	F
"INSE"	F
"INSG"	T
"INSM"	T
"INSP"	F
"INST"	T
"INSW"	F
"INT"	T
"INTA"	F
"INTC"	T
"INTE"	F
"INTR"	F
"INTT"	F
"INTU"	T
"INTZ"	F
"INVA"	T
"INVE"	T
"INVH"	T
"INVO"	F
"INVZ"	F
"INZY"	F
"IOAC"	F
"IOBT"	F
"IONQ"	F
"IONS"	T
"IOSP"	F
"IOT"	F
"IOVA"	F
"IP"	T
"IPAR"	F
"IPAX"	F
"IPG"	T
"IPGP"	T
"IPI"	T
"IPSC"	F
"IPVA"	F
"IPVF"	F
"IPVI"	F
"IPWR"	F
"IQ"	F
"IQMD"	F
"IQV"	F
"IR"	T
"IRAA"	F
"IRBT"	T
"IRDM"	T
"IREN"	F
"IRIX"	F
"IRM"	T
"IRMD"	F
"IRS"	F
"IRT"	T
"IRTC"	T
"IRWD"	T
"ISAA"	F
"ISEE"	F
"ISIG"	T
"ISO"	F
"ISPC"	F
"ISPO"	F
"ISRG"	T
"ISSC"	F
"ISUN"	F
"IT"	T
"ITAQ"	F
"ITCI"	T
"ITGR"	T
"ITI"	F
"ITOS"	F
"ITQ"	F
"ITRI"	T
"ITRM"	F
"ITRN"	F
"ITT"	T
"ITUB"	T
"ITW"	T
"IVAC"	T
"IVCB"	F
"IVCP"	F
"IVR"	T
"IVT"	F
"IVVD"	F
"IVZ"	T
"IX"	F
"IYY"	F
"J"	F
"JACK"	T
"JAG"	T
"JAGGF"	F
"JAKK"	T
"JAMF"	F
"JANX"	F
"JAQC"	F
"JAZZ"	T
"JBGS"	F
"JBHT"	T
"JBI"	F
"JBL"	T
"JBLU"	T
"JBSS"	F
"JBT"	F
"JCI"	T
"JCIC"	F
"JD"	T
"JEF"	F
"JELD"	T
"JFBR"	F
"JFIN"	F
"JGGC"	F
"JHG"	F
"JHX"	F
"JILL"	T
"JJSF"	F
"JKHY"	F
"JKS"	T
"JLL"	T
"JMAC"	F
"JMIA"	F
"JMSB"	F
"JNJ"	T
"JNPR"	T
"JOAN"	F
"JOBY"	F
"JOE"	T
"JOFF"	F
"JOUT"	F
"JPM"	T
"JRSH"	F
"JRVR"	F
"JSAIY"	F
"JT"	F
"JTKWY"	F
"JUGG"	F
"JUN"	F
"JUPW"	F
"JVA"	F
"JWN"	T
"JWSM"	F
"JXN"	F
"JYAC"	F
"JYNT"	F
"JZ"	F
"K"	T
"KACL"	F
"KAHC"	F
"KAI"	T
"KAIR"	F
"KALA"	F
"KALU"	T
"KALV"	F
"KAMN"	T
"KAR"	T
"KAVL"	F
"KB"	F
"KBAL"	T
"KBH"	T
"KBNT"	F
"KBR"	T
"KC"	F
"KD"	F
"KDNY"	F
"KDP"	F
"KE"	F
"KELYA"	T
"KEN"	F
"KEP"	T
"KEX"	T
"KEY"	T
"KEYS"	F
"KFRC"	F
"KFS"	F
"KFY"	T
"KGC"	T
"KHC"	T
"KIDS"	F
"KIII"	F
"KIM"	T
"KIND"	F
"KIRK"	T
"KITT"	F
"KKPNY"	F
"KKR"	T
"KLAC"	T
"KLAQ"	F
"KLIC"	T
"KLR"	F
"KLTR"	F
"KLXE"	F
"KMB"	T
"KMDA"	F
"KMI"	T
"KMPH"	F
"KMPR"	F
"KMT"	T
"KMTUY"	F
"KMX"	T
"KN"	T
"KNBE"	F
"KNBWY"	F
"KNDI"	T
"KNOP"	T
"KNSA"	F
"KNSL"	F
"KNSW"	F
"KNTE"	F
"KNTK"	F
"KNW"	F
"KNX"	T
"KO"	T
"KOD"	F
"KODK"	T
"KOF"	T
"KOP"	T
"KOPN"	T
"KORE"	F
"KOS"	T
"KOSS"	F
"KPRX"	F
"KPTI"	T
"KR"	T
"KRC"	F
"KREF"	F
"KRG"	T
"KRKR"	F
"KRMD"	F
"KRNL"	F
"KRNT"	F
"KRNY"	T
"KRO"	T
"KRON"	F
"KROS"	F
"KRP"	F
"KRT"	F
"KRTX"	F
"KRUS"	F
"KRYS"	F
"KSCP"	F
"KSI"	F
"KSS"	T
"KT"	T
"KTB"	F
"KTEL"	F
"KTOS"	T
"KTRA"	F
"KTTA"	F
"KUBTY"	F
"KULR"	F
"KURA"	F
"KVHI"	F
"KVSA"	F
"KVSC"	F
"KW"	T
"KWR"	F
"KYMR"	F
"KYOCY"	F
"KZR"	F
"L"	T
"LAAA"	F
"LAB"	F
"LAC"	F
"LAD"	T
"LADR"	T
"LAKE"	F
"LAMR"	T
"LANC"	F
"LAND"	F
"LASR"	F
"LATG"	F
"LAUR"	T
"LAW"	F
"LAZ"	T
"LAZR"	F
"LAZY"	F
"LBAI"	F
"LBC"	F
"LBPH"	F
"LBRDA"	T
"LBRT"	F
"LBTYA"	T
"LC"	T
"LCA"	F
"LCAA"	F
"LCID"	F
"LCII"	T
"LCNB"	F
"LCTX"	F
"LCUT"	T
"LDHA"	F
"LDI"	F
"LDOS"	T
"LE"	T
"LEA"	T
"LECO"	T
"LEG"	T
"LEGA"	F
"LEGH"	F
"LEGN"	F
"LEN"	T
"LESL"	F
"LEU"	F
"LEV"	F
"LEVI"	F
"LEXX"	F
"LFAC"	F
"LFCR"	F
"LFG"	F
"LFMD"	F
"LFST"	F
"LFT"	F
"LFUS"	T
"LFVN"	F
"LGAC"	F
"LGF.A"	F
"LGHL"	F
"LGIH"	T
"LGL"	F
"LGND"	T
"LGO"	F
"LGST"	F
"LGV"	F
"LGVC"	F
"LGVN"	F
"LH"	T
"LHAA"	F
"LHCG"	F
"LHX"	F
"LI"	F
"LIAN"	F
"LICY"	F
"LIFE"	F
"LII"	T
"LILA"	F
"LILM"	F
"LIN"	F
"LINC"	T
"LIND"	F
"LION"	T
"LITB"	T
"LITE"	T
"LITM"	F
"LITT"	F
"LIVN"	T
"LJAQ"	F
"LKFN"	F
"LKNCY"	F
"LKQ"	T
"LL"	T
"LLAP"	F
"LLY"	T
"LMACA"	F
"LMAT"	F
"LMB"	F
"LMDX"	F
"LMND"	F
"LMNR"	F
"LMST"	F
"LMT"	T
"LNC"	T
"LNG"	T
"LNKB"	F
"LNN"	T
"LNSR"	F
"LNT"	F
"LNTH"	F
"LNVGY"	F
"LNW"	F
"LOB"	T
"LOCL"	F
"LOCO"	T
"LOGI"	T
"LOKM"	F
"LOMA"	F
"LOOP"	F
"LOPE"	T
"LOV"	F
"LOVE"	F
"LOW"	T
"LPG"	F
"LPI"	T
"LPL"	T
"LPLA"	T
"LPRO"	F
"LPSN"	T
"LPTH"	F
"LPTV"	F
"LPX"	T
"LQDA"	F
"LQDT"	T
"LRCX"	T
"LRFC"	F
"LRMR"	F
"LRN"	T
"LSAK"	F
"LSCC"	T
"LSEA"	F
"LSF"	F
"LSI"	T
"LSPD"	F
"LSPR"	F
"LSTA"	F
"LSTR"	T
"LSXMA"	T
"LTBR"	F
"LTC"	F
"LTCH"	F
"LTH"	F
"LTHM"	F
"LTRN"	F
"LTRX"	F
"LU"	F
"LUCD"	F
"LUCY"	F
"LULU"	T
"LUMN"	F
"LUMO"	F
"LUNA"	F
"LUNG"	F
"LUNMF"	F
"LUV"	T
"LUXH"	F
"LVAC"	F
"LVLU"	F
"LVMUY"	F
"LVOX"	F
"LVRA"	F
"LVS"	T
"LVTX"	F
"LVWR"	F
"LW"	T
"LWAY"	F
"LWLG"	F
"LX"	F
"LXFR"	F
"LXP"	T
"LXRX"	T
"LXU"	T
"LYB"	T
"LYEL"	F
"LYFT"	F
"LYG"	T
"LYLT"	F
"LYRA"	F
"LYTS"	T
"LYV"	T
"LZ"	F
"LZB"	T
"M"	T
"MA"	T
"MAA"	T
"MAC"	T
"MACA"	F
"MACC"	F
"MACK"	T
"MAG"	T
"MAIA"	F
"MAIN"	T
"MAN"	T
"MANH"	T
"MANU"	T
"MAPS"	F
"MAQC"	F
"MAR"	T
"MARA"	T
"MARPS"	F
"MAS"	T
"MASI"	T
"MASS"	F
"MAT"	T
"MATV"	F
"MATW"	T
"MATX"	T
"MAX"	F
"MAXN"	F
"MAXR"	F
"MBAC"	F
"MBCN"	F
"MBGAF"	F
"MBI"	T
"MBIN"	F
"MBLY"	T
"MBRX"	F
"MBSC"	F
"MBUU"	T
"MBWM"	F
"MC"	T
"MCAA"	F
"MCAE"	F
"MCAF"	F
"MCAG"	F
"MCB"	F
"MCBC"	F
"MCBS"	F
"MCD"	T
"MCFT"	F
"MCG"	F
"MCHP"	T
"MCHX"	F
"MCK"	T
"MCO"	T
"MCRB"	T
"MCRI"	T
"MCS"	F
"MCVT"	F
"MCW"	F
"MCY"	F
"MD"	T
"MDB"	F
"MDC"	T
"MDGL"	F
"MDGS"	F
"MDH"	F
"MDLZ"	T
"MDRX"	T
"MDT"	T
"MDU"	T
"MDV"	F
"MDWD"	F
"MDXG"	T
"ME"	F
"MEAC"	F
"MEC"	F
"MED"	T
"MEDP"	F
"MEG"	F
"MEGL"	F
"MEI"	T
"MEKA"	F
"MELI"	T
"MEOH"	T
"MERC"	T
"MESA"	F
"MESO"	F
"MET"	T
"META"	F
"METC"	F
"MF"	F
"MFA"	T
"MFC"	T
"MFG"	T
"MFGP"	F
"MFIC"	F
"MFIN"	T
"MG"	T
"MGA"	T
"MGEE"	T
"MGI"	T
"MGIC"	T
"MGM"	T
"MGNI"	F
"MGNX"	F
"MGPI"	T
"MGRC"	F
"MGTA"	F
"MGTX"	F
"MGY"	F
"MHH"	F
"MHK"	T
"MHLD"	T
"MHO"	T
"MICS"	F
"MICT"	F
"MIDD"	T
"MIMO"	F
"MIR"	F
"MIRM"	F
"MIRO"	F
"MIST"	F
"MIT"	F
"MITA"	F
"MITK"	T
"MITQ"	F
"MITT"	T
"MIXT"	F
"MKC"	T
"MKFG"	F
"MKKGY"	F
"MKL"	T
"MKSI"	T
"MKTAY"	F
"MKTW"	F
"MKTX"	T
"MLAB"	F
"MLAI"	F
"MLCO"	T
"MLI"	F
"MLKN"	F
"MLM"	T
"MLNK"	T
"MLR"	F
"MLTX"	F
"MLVF"	F
"MMAT"	F
"MMC"	T
"MMED"	F
"MMI"	F
"MMLP"	T
"MMM"	T
"MMMB"	F
"MMP"	T
"MMS"	F
"MMSI"	T
"MMX"	F
"MMYT"	T
"MNDO"	F
"MNDY"	F
"MNK"	T
"MNKD"	T
"MNOV"	F
"MNPR"	F
"MNRL"	F
"MNRO"	T
"MNSB"	F
"MNSO"	F
"MNST"	T
"MNTK"	F
"MNTN"	F
"MNTS"	F
"MNTV"	F
"MNTX"	T
"MO"	T
"MOBQ"	F
"MOD"	F
"MODG"	F
"MODN"	T
"MODV"	F
"MOFG"	F
"MOG.A"	F
"MOGU"	F
"MOH"	T
"MOMO"	T
"MOND"	F
"MOR"	F
"MORF"	F
"MORN"	T
"MOS"	T
"MOTS"	F
"MOV"	T
"MOVE"	F
"MP"	F
"MPAA"	T
"MPAC"	F
"MPB"	F
"MPC"	T
"MPLN"	F
"MPLX"	T
"MPW"	T
"MPWR"	T
"MPX"	T
"MQ"	F
"MRAI"	F
"MRAM"	F
"MRBK"	F
"MRC"	T
"MRCY"	T
"MRIN"	T
"MRK"	T
"MRNA"	F
"MRNS"	F
"MRO"	T
"MRSN"	F
"MRTN"	T
"MRTX"	F
"MRUS"	F
"MRVI"	F
"MRVL"	T
"MS"	T
"MSA"	F
"MSAC"	F
"MSB"	T
"MSBI"	F
"MSCI"	T
"MSEX"	F
"MSFT"	T
"MSGE"	F
"MSGM"	F
"MSGS"	F
"MSI"	T
"MSM"	T
"MSTR"	T
"MT"	T
"MTA"	F
"MTAC"	F
"MTB"	T
"MTBC"	F
"MTC"	F
"MTCH"	T
"MTD"	F
"MTDR"	T
"MTEK"	F
"MTG"	T
"MTH"	T
"MTLS"	F
"MTMT"	F
"MTN"	T
"MTP"	F
"MTR"	F
"MTRN"	T
"MTRX"	T
"MTSI"	T
"MTTR"	F
"MTVC"	F
"MTW"	T
"MTX"	T
"MTZ"	T
"MU"	T
"MUFG"	F
"MUR"	T
"MURF"	F
"MUSA"	T
"MUX"	T
"MVBF"	F
"MVIS"	T
"MVO"	T
"MVST"	F
"MWA"	T
"MX"	T
"MXCT"	F
"MXL"	T
"MYE"	T
"MYFW"	F
"MYGN"	T
"MYMD"	F
"MYNZ"	F
"MYOV"	F
"MYPS"	F
"MYRG"	T
"MYTE"	F
"NAAC"	F
"NAAS"	F
"NABL"	F
"NABZY"	F
"NAD"	F
"NAMS"	F
"NANX"	F
"NAPA"	F
"NARI"	F
"NAT"	T
"NATI"	F
"NATR"	F
"NAUT"	F
"NAVI"	T
"NBHC"	T
"NBIX"	T
"NBN"	F
"NBR"	T
"NBRV"	F
"NBST"	F
"NBTB"	F
"NBY"	F
"NC"	F
"NCAC"	F
"NCLH"	T
"NCNO"	F
"NCPL"	F
"NCR"	T
"NCRA"	F
"NDAC"	F
"NDAQ"	T
"NDLS"	T
"NDSN"	T
"NE"	T
"NECB"	F
"NEE"	T
"NEGG"	F
"NEM"	T
"NEO"	T
"NEOG"	F
"NEON"	T
"NEOV"	F
"NEP"	T
"NEPH"	F
"NERV"	T
"NET"	F
"NETC"	F
"NETI"	F
"NEU"	T
"NEWR"	T
"NEWT"	F
"NEX"	F
"NEXA"	F
"NEXT"	F
"NFBK"	T
"NFE"	F
"NFG"	T
"NFLX"	T
"NFNT"	F
"NG"	T
"NGC"	F
"NGD"	T
"NGG"	T
"NGL"	T
"NGLOY"	F
"NGM"	F
"NGMS"	F
"NGS"	T
"NGVC"	T
"NGVT"	F
"NHC"	T
"NHI"	F
"NHIC"	F
"NHTC"	T
"NHWK"	F
"NHYDY"	F
"NI"	T
"NIC"	F
"NICE"	T
"NICK"	F
"NINE"	F
"NIO"	F
"NIU"	F
"NJDCY"	F
"NJR"	F
"NKE"	T
"NKLA"	F
"NKSH"	F
"NKTR"	T
"NKTX"	F
"NL"	F
"NLCP"	F
"NLS"	T
"NLST"	T
"NLY"	T
"NM"	T
"NMI"	F
"NMIH"	T
"NMM"	T
"NMR"	T
"NMRK"	F
"NMTC"	F
"NMTR"	F
"NN"	F
"NNBR"	T
"NNDM"	F
"NNI"	T
"NNN"	T
"NNOX"	F
"NNVC"	T
"NNY"	F
"NOA"	T
"NOAH"	T
"NOC"	T
"NOG"	T
"NOK"	T
"NOMD"	F
"NOTE"	F
"NOTV"	F
"NOU"	F
"NOV"	T
"NOVA"	F
"NOVT"	T
"NOW"	T
"NPAB"	F
"NPCE"	F
"NPK"	F
"NPO"	T
"NPSNY"	F
"NR"	T
"NRBO"	F
"NRC"	F
"NRDS"	F
"NRDY"	F
"NREF"	F
"NRG"	T
"NRGV"	F
"NRIM"	F
"NRIX"	F
"NRP"	T
"NRSN"	F
"NRT"	T
"NRXP"	F
"NS"	T
"NSA"	T
"NSANY"	F
"NSC"	T
"NSIT"	T
"NSP"	T
"NSPR"	F
"NSSC"	F
"NSTB"	F
"NSTC"	F
"NSTD"	F
"NSTG"	T
"NSTS"	F
"NSYS"	F
"NTAP"	T
"NTB"	F
"NTCT"	T
"NTES"	T
"NTGR"	T
"NTIC"	F
"NTIP"	F
"NTLA"	T
"NTNX"	T
"NTR"	F
"NTRA"	T
"NTRS"	T
"NTST"	F
"NTTYY"	F
"NU"	F
"NUAG"	F
"NUE"	T
"NURO"	F
"NUS"	T
"NUTX"	F
"NUV"	F
"NUVA"	T
"NUVB"	F
"NUVL"	F
"NVAC"	F
"NVAX"	T
"NVCR"	T
"NVCT"	F
"NVDA"	T
"NVEC"	F
"NVEE"	T
"NVEI"	F
"NVGS"	T
"NVIV"	F
"NVMI"	T
"NVNO"	F
"NVO"	T
"NVR"	F
"NVRO"	T
"NVS"	T
"NVST"	F
"NVT"	F
"NVTA"	T
"NVTS"	F
"NWBI"	F
"NWE"	T
"NWG"	F
"NWL"	T
"NWN"	F
"NWPX"	T
"NWSA"	T
"NWTN"	F
"NX"	T
"NXDT"	F
"NXE"	F
"NXGN"	F
"NXL"	F
"NXP"	F
"NXPI"	T
"NXPL"	F
"NXRT"	T
"NXST"	T
"NXTC"	F
"NYC"	F
"NYCB"	T
"NYMT"	T
"NYT"	T
"O"	T
"OABI"	F
"OB"	F
"OBE"	F
"OBNK"	F
"OC"	T
"OCAX"	F
"OCFC"	F
"OCGN"	F
"OCN"	T
"OCUL"	T
"OCUP"	F
"ODFL"	T
"ODP"	T
"ODV"	F
"OEC"	F
"OEPW"	F
"OESX"	T
"OFC"	T
"OFG"	T
"OFIX"	T
"OFLX"	F
"OFSTF"	F
"OGE"	T
"OGI"	F
"OGN"	F
"OGS"	T
"OHAA"	F
"OHI"	T
"OHPA"	F
"OI"	T
"OII"	T
"OIIM"	F
"OIS"	T
"OKE"	T
"OKTA"	F
"OLA"	F
"OLED"	T
"OLIT"	F
"OLK"	F
"OLLI"	T
"OLMA"	F
"OLN"	T
"OLO"	F
"OLP"	F
"OLPX"	F
"OM"	F
"OMAB"	F
"OMC"	T
"OMCL"	F
"OMEG"	F
"OMER"	T
"OMEX"	T
"OMF"	T
"OMGA"	F
"OMI"	F
"OMIC"	F
"OMQS"	F
"ON"	T
"ONB"	T
"ONC"	F
"ONCS"	F
"ONCY"	F
"ONDS"	F
"ONEM"	F
"ONEW"	F
"ONFO"	F
"ONL"	F
"ONON"	F
"ONTF"	F
"ONTO"	F
"ONVO"	T
"ONYX"	F
"OOMA"	T
"OPAL"	F
"OPBK"	F
"OPCH"	F
"OPEN"	F
"OPFI"	F
"OPHC"	F
"OPI"	F
"OPK"	T
"OPNT"	F
"OPRA"	F
"OPRT"	F
"OPRX"	F
"OPTN"	F
"OPXS"	F
"OPY"	F
"OR"	F
"ORA"	T
"ORAN"	T
"ORC"	T
"ORCC"	F
"ORCL"	T
"ORGN"	F
"ORGO"	F
"ORGS"	F
"ORI"	T
"ORIA"	F
"ORIC"	F
"ORLY"	T
"ORMP"	T
"ORN"	T
"ORPB"	F
"ORRF"	F
"OSBC"	F
"OSCR"	F
"OSG"	F
"OSH"	F
"OSI"	F
"OSIS"	T
"OSK"	T
"OSPN"	F
"OSS"	F
"OST"	F
"OSTK"	T
"OSTR"	F
"OSUR"	T
"OSW"	F
"OTEC"	F
"OTEX"	T
"OTIS"	F
"OTLK"	F
"OTLY"	F
"OTTR"	F
"OUST"	F
"OUT"	T
"OVID"	F
"OVV"	F
"OWL"	F
"OXAC"	F
"OXM"	T
"OXY"	T
"OYST"	F
"OZK"	F
"PAA"	T
"PAAS"	T
"PAC"	F
"PACB"	T
"PACI"	F
"PACK"	F
"PACW"	T
"PACX"	F
"PAFO"	F
"PAG"	T
"PAGP"	T
"PAGS"	F
"PAHC"	F
"PALI"	F
"PALT"	F
"PAM"	T
"PANA"	F
"PANL"	F
"PANW"	T
"PAR"	F
"PARA"	F
"PARR"	T
"PASG"	F
"PATH"	F
"PATK"	T
"PAX"	F
"PAY"	T
"PAYA"	F
"PAYC"	T
"PAYO"	F
"PAYS"	F
"PAYX"	T
"PB"	F
"PBAX"	F
"PBF"	T
"PBFS"	F
"PBFX"	T
"PBH"	F
"PBI"	T
"PBIO"	F
"PBPB"	T
"PBR"	T
"PBT"	T
"PBYI"	T
"PCAR"	T
"PCB"	F
"PCG"	T
"PCH"	F
"PCM"	F
"PCOR"	F
"PCPC"	F
"PCRFY"	F
"PCRX"	T
"PCSA"	F
"PCSB"	F
"PCT"	F
"PCTI"	F
"PCTY"	T
"PCVX"	F
"PCYG"	T
"PCYO"	F
"PD"	F
"PDCE"	T
"PDCO"	T
"PDD"	F
"PDFS"	T
"PDLB"	F
"PDM"	T
"PDOT"	F
"PDS"	T
"PDSB"	F
"PEAK"	F
"PEAR"	F
"PEB"	T
"PEBO"	F
"PECO"	F
"PED"	F
"PEG"	T
"PEGA"	T
"PEGY"	F
"PEI"	T
"PEN"	F
"PENN"	T
"PEP"	T
"PEPG"	F
"PERF"	F
"PERI"	T
"PESI"	F
"PET"	F
"PETQ"	F
"PETS"	T
"PETV"	F
"PETZ"	F
"PEV"	F
"PFBC"	F
"PFC"	F
"PFDR"	F
"PFE"	T
"PFG"	T
"PFGC"	T
"PFHD"	F
"PFIE"	F
"PFLC"	F
"PFMT"	T
"PFS"	F
"PFSI"	F
"PFSW"	T
"PFTA"	F
"PG"	T
"PGC"	F
"PGEN"	F
"PGNY"	F
"PGR"	T
"PGRE"	F
"PGTI"	T
"PGY"	F
"PH"	T
"PHAT"	F
"PHG"	T
"PHI"	F
"PHIC"	F
"PHM"	T
"PHR"	F
"PHUN"	F
"PHVS"	F
"PHX"	T
"PHYT"	F
"PI"	T
"PIAI"	F
"PICC"	F
"PII"	T
"PIII"	F
"PIM"	F
"PINC"	T
"PINE"	F
"PINS"	F
"PIPR"	F
"PIRS"	F
"PIXY"	F
"PJT"	T
"PK"	T
"PKBK"	F
"PKBO"	F
"PKE"	F
"PKG"	T
"PKI"	T
"PKOH"	F
"PKX"	T
"PL"	F
"PLAB"	F
"PLAO"	F
"PLAY"	T
"PLBY"	F
"PLCE"	T
"PLD"	T
"PLG"	F
"PLM"	F
"PLMI"	F
"PLMR"	F
"PLNT"	T
"PLOW"	T
"PLRX"	F
"PLSE"	F
"PLTK"	F
"PLTNU"	F
"PLTR"	F
"PLUG"	T
"PLUS"	F
"PLXS"	T
"PLYA"	F
"PLYM"	F
"PM"	T
"PMCB"	F
"PMGM"	F
"PMM"	F
"PMO"	F
"PMT"	T
"PMTS"	T
"PMVP"	F
"PNBK"	F
"PNC"	T
"PNFP"	T
"PNM"	T
"PNR"	T
"PNT"	F
"PNTG"	F
"PNW"	F
"POCI"	F
"PODD"	T
"POET"	F
"POLA"	F
"POM"	F
"POND"	F
"PONO"	F
"POOL"	T
"POR"	T
"PORT"	F
"POSH"	F
"POST"	T
"POW"	F
"POWI"	T
"POWL"	F
"POWW"	F
"PPBI"	F
"PPC"	T
"PPG"	T
"PPHP"	F
"PPL"	T
"PPSI"	F
"PPT"	F
"PPTA"	F
"PPYA"	F
"PR"	F
"PRA"	T
"PRAA"	T
"PRAX"	F
"PRBM"	F
"PRCH"	F
"PRCT"	F
"PRDO"	F
"PRDS"	F
"PRE"	F
"PRFT"	T
"PRG"	F
"PRGO"	T
"PRGS"	T
"PRI"	T
"PRIM"	T
"PRK"	T
"PRLB"	T
"PRLD"	F
"PRLH"	F
"PRM"	F
"PRME"	F
"PRMRF"	F
"PRMW"	T
"PRN"	F
"PRO"	T
"PROC"	F
"PROK"	F
"PRPC"	F
"PRPH"	F
"PRPL"	F
"PRQR"	F
"PRSO"	F
"PRSR"	F
"PRST"	F
"PRT"	F
"PRTA"	T
"PRTG"	F
"PRTH"	F
"PRTK"	T
"PRTS"	F
"PRU"	T
"PRVA"	F
"PRVB"	F
"PSA"	T
"PSAG"	F
"PSFE"	F
"PSHG"	F
"PSIX"	F
"PSMT"	T
"PSN"	F
"PSNL"	F
"PSNY"	F
"PSO"	T
"PSPC"	F
"PSTG"	T
"PSTL"	F
"PSTX"	F
"PSX"	T
"PTC"	T
"PTCT"	T
"PTEN"	T
"PTGX"	F
"PTIC"	F
"PTLO"	F
"PTM"	T
"PTN"	F
"PTOC"	F
"PTON"	F
"PTRA"	F
"PTRS"	F
"PTSI"	F
"PTVE"	F
"PUBGY"	F
"PUBM"	F
"PUCK"	F
"PUK"	T
"PULM"	F
"PUMP"	F
"PV"	F
"PVBC"	F
"PVH"	T
"PVL"	F
"PW"	F
"PWFL"	F
"PWP"	F
"PWR"	T
"PWSC"	F
"PX"	T
"PXD"	T
"PXLW"	T
"PXMD"	F
"PXS"	F
"PYCR"	F
"PYPL"	T
"PYXS"	F
"PZZA"	T
"QBAK"	F
"QBTS"	F
"QCOM"	T
"QCRH"	F
"QDEL"	T
"QFIN"	F
"QFTA"	F
"QGEN"	T
"QH"	F
"QIPT"	F
"QLGN"	F
"QLYS"	T
"QMCO"	F
"QNRX"	F
"QNST"	T
"QRHC"	F
"QRTEA"	F
"QRVO"	T
"QS"	F
"QSI"	F
"QSR"	T
"QTRH"	F
"QTRX"	F
"QTWO"	T
"QUAD"	T
"QUBT"	F
"QUIK"	T
"QUOT"	T
"QURE"	T
"R"	T
"RACB"	F
"RACY"	F
"RAD"	T
"RADA"	F
"RADI"	F
"RAIL"	T
"RAIN"	F
"RAM"	F
"RAMP"	F
"RANI"	F
"RAPT"	F
"RARE"	T
"RAVE"	F
"RBA"	T
"RBB"	F
"RBBN"	F
"RBC"	T
"RBCAA"	F
"RBLX"	F
"RBOT"	F
"RBT"	F
"RC"	F
"RCAC"	F
"RCAT"	F
"RCEL"	F
"RCFA"	F
"RCI"	T
"RCI.B"	F
"RCII"	T
"RCKT"	F
"RCKY"	F
"RCL"	T
"RCLF"	F
"RCM"	F
"RCMT"	F
"RCOR"	F
"RCS"	F
"RCUS"	F
"RDCM"	F
"RDFN"	F
"RDI"	T
"RDN"	T
"RDNT"	T
"RDVT"	F
"RDW"	F
"RDWR"	T
"RDY"	T
"RE"	T
"REAL"	F
"REAX"	F
"RECAF"	F
"REFI"	F
"REFR"	T
"REG"	T
"REGN"	T
"REGX"	F
"REI"	T
"RELL"	F
"RELX"	F
"RELY"	T
"RENN"	T
"RENT"	F
"REPL"	F
"REPX"	F
"REPYY"	F
"RERE"	F
"RES"	T
"RETA"	F
"REUN"	F
"REVE"	F
"REVG"	T
"REVH"	F
"REVRQ"	F
"REX"	F
"REXR"	T
"REYN"	F
"REZI"	F
"RF"	T
"RFIL"	F
"RFL"	F
"RFP"	T
"RGA"	T
"RGEN"	T
"RGF"	F
"RGLD"	T
"RGLS"	T
"RGNX"	F
"RGP"	F
"RGR"	T
"RGS"	T
"RGTI"	F
"RH"	T
"RHHBY"	F
"RHI"	T
"RHP"	T
"RIBT"	F
"RICK"	T
"RIDE"	F
"RIG"	T
"RILY"	F
"RIO"	T
"RIOT"	F
"RITM"	F
"RIVN"	F
"RJF"	T
"RKLB"	F
"RKT"	F
"RL"	T
"RLAY"	F
"RLGT"	F
"RLI"	T
"RLJ"	T
"RLMD"	F
"RLX"	F
"RLYB"	F
"RM"	T
"RMAX"	T
"RMBL"	F
"RMBS"	T
"RMD"	T
"RMED"	F
"RMGC"	F
"RMNI"	F
"RMR"	F
"RMTI"	T
"RNA"	F
"RNER"	F
"RNG"	T
"RNGR"	F
"RNLX"	F
"RNR"	T
"RNST"	F
"RNW"	F
"ROAD"	F
"ROC"	F
"ROCC"	F
"ROCG"	F
"ROCK"	T
"ROCL"	F
"ROG"	T
"ROIC"	T
"ROIV"	F
"ROK"	T
"ROKU"	F
"ROL"	F
"RONI"	F
"ROOT"	F
"ROP"	T
"ROSS"	F
"ROST"	T
"ROVR"	F
"RPAY"	F
"RPD"	T
"RPHM"	F
"RPID"	F
"RPM"	T
"RPMT"	F
"RPRX"	T
"RPT"	T
"RPTX"	F
"RRAC"	F
"RRC"	T
"RRGB"	T
"RRR"	T
"RRX"	F
"RS"	T
"RSG"	T
"RSI"	F
"RSKD"	F
"RSSS"	F
"RSVR"	F
"RTL"	F
"RTO"	F
"RTX"	F
"RUM"	F
"RUN"	T
"RUSHA"	T
"RUTH"	T
"RVLP"	F
"RVLV"	F
"RVMD"	F
"RVNC"	T
"RVP"	F
"RVPH"	F
"RVSB"	F
"RVT"	F
"RWAY"	F
"RWEOY"	F
"RWT"	T
"RXDX"	F
"RXO"	F
"RXRA"	F
"RXRX"	F
"RXST"	F
"RXT"	F
"RY"	T
"RYAAY"	T
"RYAM"	T
"RYAN"	F
"RYCEY"	F
"RYI"	T
"RYN"	T
"RYTM"	F
"RZLT"	F
"S"	T
"SA"	T
"SABR"	T
"SABS"	F
"SACH"	F
"SAFE"	F
"SAFT"	F
"SAGE"	T
"SAH"	T
"SAIA"	F
"SAIC"	T
"SALM"	F
"SAM"	T
"SAMA"	F
"SAMG"	F
"SAN"	T
"SANA"	F
"SANM"	T
"SANW"	T
"SAP"	T
"SAR"	F
"SASR"	F
"SATL"	F
"SATS"	T
"SATX"	F
"SAVA"	F
"SAVE"	T
"SAWLF"	F
"SB"	T
"SBAC"	T
"SBCF"	F
"SBEV"	F
"SBGI"	T
"SBH"	T
"SBII"	F
"SBLK"	T
"SBNY"	T
"SBOW"	F
"SBR"	F
"SBRA"	T
"SBS"	T
"SBSI"	T
"SBSW"	F
"SBT"	F
"SBUX"	T
"SCAQ"	F
"SCCO"	T
"SCGLY"	F
"SCHL"	T
"SCHN"	T
"SCHW"	T
"SCI"	T
"SCKT"	F
"SCL"	F
"SCLE"	F
"SCLX"	F
"SCOA"	F
"SCOB"	F
"SCOR"	T
"SCPH"	F
"SCPL"	F
"SCRM"	F
"SCS"	T
"SCSC"	T
"SCTL"	F
"SCU"	F
"SCUA"	F
"SCVL"	T
"SCWO"	F
"SCWX"	T
"SCX"	F
"SCYX"	F
"SD"	T
"SDAC"	F
"SDGR"	F
"SDXAY"	F
"SE"	F
"SEA"	T
"SEAS"	T
"SEAT"	F
"SEDG"	T
"SEE"	T
"SEED"	T
"SEER"	F
"SEIC"	T
"SELB"	F
"SELF"	F
"SEM"	T
"SEMR"	F
"SENEA"	F
"SENS"	F
"SEOAY"	F
"SERA"	F
"SES"	F
"SEV"	F
"SEVN"	F
"SF"	T
"SFBS"	F
"SFE"	T
"SFIX"	F
"SFL"	T
"SFM"	T
"SFNC"	F
"SFST"	F
"SG"	F
"SGBX"	F
"SGC"	F
"SGEN"	T
"SGFY"	F
"SGH"	F
"SGHC"	F
"SGHT"	F
"SGMA"	F
"SGML"	F
"SGMO"	T
"SGRP"	F
"SGRY"	T
"SGU"	F
"SHAC"	F
"SHAK"	T
"SHAP"	F
"SHBI"	F
"SHC"	F
"SHCA"	F
"SHCAY"	F
"SHCR"	F
"SHEL"	F
"SHEN"	T
"SHFS"	F
"SHG"	F
"SHLS"	F
"SHO"	F
"SHOO"	T
"SHOP"	T
"SHQA"	F
"SHW"	T
"SHWZ"	F
"SHYF"	F
"SI"	F
"SIBN"	F
"SID"	T
"SIDU"	F
"SIEB"	F
"SIEGY"	F
"SIFY"	T
"SIG"	T
"SIGA"	F
"SIGI"	T
"SII"	F
"SIL"	T
"SILC"	F
"SILK"	F
"SILO"	F
"SIMO"	T
"SIRE"	F
"SIRI"	T
"SITC"	F
"SITE"	F
"SITM"	F
"SIVB"	T
"SIX"	T
"SJ"	F
"SJI"	F
"SJM"	T
"SJR"	T
"SJR.B"	F
"SJT"	T
"SJW"	F
"SKE"	F
"SKFRY"	F
"SKIL"	F
"SKIN"	F
"SKM"	T
"SKT"	T
"SKX"	T
"SKY"	F
"SKYA"	F
"SKYT"	F
"SKYW"	T
"SKYX"	F
"SLAB"	T
"SLAC"	F
"SLAM"	F
"SLB"	T
"SLCA"	T
"SLDB"	F
"SLDP"	F
"SLF"	T
"SLG"	T
"SLGC"	F
"SLGN"	T
"SLI"	F
"SLM"	T
"SLNA"	F
"SLNG"	F
"SLNO"	F
"SLP"	F
"SLRX"	F
"SLS"	F
"SLVM"	F
"SLVR"	F
"SM"	T
"SMAR"	F
"SMBC"	F
"SMBK"	F
"SMCI"	T
"SMFG"	T
"SMG"	T
"SMHI"	F
"SMIH"	F
"SMLP"	T
"SMLR"	F
"SMMF"	F
"SMP"	T
"SMPL"	F
"SMR"	F
"SMRT"	T
"SMSI"	T
"SMTC"	T
"SMTI"	F
"SMWB"	F
"SNA"	T
"SNAL"	F
"SNAP"	T
"SNBR"	F
"SNCY"	F
"SND"	F
"SNDL"	F
"SNDR"	F
"SNDX"	F
"SNES"	F
"SNEX"	F
"SNFCA"	F
"SNN"	T
"SNOA"	F
"SNOW"	T
"SNPO"	F
"SNPS"	T
"SNPTY"	F
"SNPX"	F
"SNRH"	F
"SNSE"	F
"SNT"	F
"SNTG"	F
"SNTI"	F
"SNV"	T
"SNX"	T
"SNY"	T
"SO"	T
"SOBR"	F
"SOFI"	F
"SOHO"	F
"SOHU"	T
"SOI"	F
"SOL"	T
"SOLO"	F
"SON"	T
"SOND"	F
"SONO"	F
"SONX"	F
"SONY"	F
"SOPA"	F
"SOPH"	F
"SOS"	F
"SOUN"	F
"SOVO"	F
"SOY"	F
"SP"	T
"SPB"	T
"SPCB"	F
"SPCE"	F
"SPFI"	F
"SPG"	T
"SPGI"	T
"SPGS"	F
"SPH"	T
"SPI"	F
"SPIR"	F
"SPKB"	F
"SPKKY"	F
"SPLK"	T
"SPNE"	T
"SPNS"	T
"SPNT"	F
"SPOK"	F
"SPOT"	F
"SPR"	T
"SPRB"	F
"SPRO"	F
"SPRY"	F
"SPSC"	T
"SPT"	F
"SPTK"	F
"SPTN"	F
"SPWH"	T
"SPWR"	T
"SPXC"	T
"SQ"	T
"SQFT"	F
"SQM"	T
"SQNS"	F
"SQSP"	F
"SQZ"	F
"SR"	T
"SRAD"	F
"SRAX"	F
"SRC"	T
"SRCE"	F
"SRCL"	T
"SRDX"	T
"SRE"	T
"SRG"	F
"SRGA"	F
"SRI"	T
"SRNE"	T
"SRPT"	T
"SRRK"	F
"SRT"	T
"SRTS"	F
"SSAA"	F
"SSB"	F
"SSD"	T
"SSDOY"	F
"SSL"	T
"SSLZY"	F
"SSNC"	F
"SSNT"	F
"SSP"	T
"SSRM"	F
"SST"	F
"SSTI"	F
"SSTK"	T
"SSU"	F
"SSYS"	T
"ST"	T
"STAA"	T
"STAF"	F
"STAG"	T
"STAR"	T
"STBA"	F
"STBX"	F
"STC"	T
"STCN"	F
"STE"	T
"STEL"	F
"STEM"	F
"STEP"	F
"STER"	F
"STET"	F
"STG"	F
"STGW"	F
"STIM"	F
"STKH"	F
"STKL"	T
"STKS"	F
"STLD"	T
"STM"	T
"STN"	F
"STNE"	F
"STNG"	T
"STOK"	F
"STOR"	T
"STR"	F
"STRA"	T
"STRC"	F
"STRE"	F
"STRL"	T
"STRM"	F
"STRN"	F
"STRO"	F
"STRS"	F
"STSFF"	F
"STSS"	F
"STT"	T
"STTK"	F
"STVN"	F
"STWD"	T
"STX"	T
"STXS"	F
"STZ"	T
"SU"	T
"SUAC"	F
"SUHJY"	F
"SUI"	T
"SUM"	T
"SUMO"	F
"SUN"	T
"SUNL"	F
"SUNW"	T
"SUP"	F
"SUPN"	T
"SUPV"	F
"SURG"	F
"SVC"	F
"SVFA"	F
"SVFB"	F
"SVFD"	F
"SVM"	F
"SVNA"	F
"SVRA"	F
"SW"	F
"SWAV"	F
"SWBI"	F
"SWCH"	F
"SWDBY"	F
"SWET"	F
"SWI"	F
"SWIM"	F
"SWIR"	T
"SWK"	T
"SWKS"	T
"SWN"	T
"SWTX"	F
"SWX"	F
"SXC"	T
"SXI"	F
"SXT"	T
"SYBT"	F
"SYF"	T
"SYK"	T
"SYM"	F
"SYNA"	T
"SYNH"	F
"SYPR"	F
"SYRS"	F
"SYY"	T
"SZZL"	F
"T"	T
"TA"	T
"TAC"	F
"TACT"	F
"TAIT"	F
"TAK"	F
"TAL"	T
"TALO"	F
"TALS"	F
"TANH"	F
"TAP"	T
"TARA"	F
"TARS"	F
"TASK"	F
"TAST"	T
"TBBK"	F
"TBCP"	F
"TBI"	T
"TBK"	F
"TBLA"	F
"TBLT"	F
"TBNK"	F
"TBPH"	F
"TC"	F
"TCBI"	T
"TCBK"	F
"TCBP"	F
"TCBX"	F
"TCMD"	F
"TCN"	F
"TCOA"	F
"TCOM"	F
"TCON"	F
"TCPC"	T
"TCRR"	F
"TCRX"	F
"TCS"	T
"TCVA"	F
"TCX"	T
"TD"	T
"TDC"	T
"TDCX"	F
"TDG"	T
"TDOC"	T
"TDS"	T
"TDUP"	F
"TDW"	T
"TDY"	F
"TEAM"	T
"TECH"	F
"TECK"	T
"TECK.B"	F
"TEF"	T
"TEI"	F
"TEL"	T
"TELA"	F
"TELL"	F
"TELNY"	F
"TENB"	F
"TEO"	T
"TER"	T
"TERN"	F
"TESS"	F
"TETC"	F
"TEVA"	T
"TEX"	T
"TFC"	F
"TFFP"	F
"TFII"	F
"TFPM"	F
"TFSL"	T
"TFX"	F
"TG"	T
"TGAA"	F
"TGAN"	F
"TGB"	T
"TGH"	F
"TGI"	T
"TGL"	F
"TGLS"	F
"TGNA"	T
"TGS"	F
"TGT"	T
"TGTX"	T
"TH"	F
"THAC"	F
"THC"	T
"THCA"	F
"THCH"	F
"THCP"	F
"THFF"	F
"THG"	F
"THO"	T
"THR"	F
"THRD"	F
"THRM"	T
"THRN"	F
"THRX"	F
"THRY"	F
"THS"	T
"TIG"	F
"TIGO"	F
"TIGR"	F
"TIIAY"	F
"TIL"	F
"TILE"	T
"TIMB"	F
"TIOA"	F
"TIPT"	F
"TIRX"	F
"TITN"	T
"TIVC"	F
"TIXT"	F
"TJX"	T
"TK"	T
"TKC"	T
"TKLF"	F
"TKNO"	F
"TKO"	F
"TKOMY"	F
"TKR"	T
"TLGA"	F
"TLGPY"	F
"TLK"	F
"TLRY"	F
"TLS"	F
"TLYS"	T
"TM"	T
"TMAC"	F
"TMBR"	F
"TMCI"	F
"TMDX"	F
"TME"	F
"TMHC"	T
"TMKR"	F
"TMO"	T
"TMP"	F
"TMPO"	F
"TMRC"	F
"TMST"	F
"TMUS"	T
"TNC"	F
"TNDM"	T
"TNET"	T
"TNGX"	F
"TNK"	T
"TNL"	F
"TNON"	F
"TNP"	T
"TNYA"	F
"TOI"	F
"TOL"	T
"TOPS"	F
"TOST"	F
"TOSYY"	F
"TOWN"	F
"TPB"	F
"TPC"	T
"TPCS"	F
"TPG"	F
"TPH"	T
"TPIC"	F
"TPL"	F
"TPR"	F
"TPVG"	F
"TPX"	T
"TR"	F
"TRAQ"	F
"TRC"	T
"TRDA"	F
"TREE"	T
"TREX"	T
"TRGP"	T
"TRHC"	F
"TRI"	T
"TRIB"	T
"TRIN"	F
"TRIP"	T
"TRIS"	F
"TRMB"	T
"TRMK"	F
"TRN"	T
"TRNO"	T
"TRNS"	F
"TRON"	F
"TROO"	F
"TROW"	T
"TROX"	T
"TRP"	T
"TRQ"	T
"TRS"	T
"TRST"	T
"TRT"	F
"TRTL"	F
"TRTN"	T
"TRTX"	F
"TRU"	T
"TRUE"	T
"TRUP"	F
"TRV"	T
"TRVG"	T
"TRVI"	F
"TRVN"	T
"TS"	T
"TSAT"	F
"TSBK"	F
"TSCDY"	F
"TSCO"	T
"TSE"	T
"TSEM"	T
"TSHA"	F
"TSIB"	F
"TSLA"	T
"TSM"	T
"TSN"	T
"TSP"	F
"TSPQ"	F
"TSQ"	T
"TSVT"	F
"TT"	F
"TTC"	T
"TTCF"	F
"TTD"	F
"TTE"	F
"TTEC"	T
"TTEK"	T
"TTGT"	F
"TTI"	T
"TTM"	T
"TTMI"	T
"TTNDY"	F
"TTOO"	F
"TTSH"	F
"TTWO"	T
"TU"	T
"TUP"	T
"TURN"	F
"TUSK"	F
"TUYA"	F
"TV"	T
"TVTX"	F
"TW"	F
"TWI"	T
"TWIN"	F
"TWKS"	F
"TWLO"	T
"TWLV"	F
"TWNI"	F
"TWNK"	T
"TWO"	T
"TWOA"	F
"TWOU"	T
"TWST"	F
"TX"	T
"TXG"	F
"TXMD"	T
"TXN"	T
"TXRH"	T
"TXT"	T
"TYL"	T
"TYRA"	F
"TZOO"	T
"TZPS"	F
"U"	F
"UAA"	T
"UAL"	T
"UAN"	T
"UBA"	F
"UBER"	F
"UBS"	T
"UBSI"	F
"UBX"	F
"UCBI"	F
"UCL"	F
"UCTT"	T
"UDMY"	F
"UDR"	T
"UE"	F
"UEC"	T
"UEIC"	F
"UFCS"	F
"UFI"	T
"UFPI"	T
"UFPT"	F
"UGI"	T
"UGP"	T
"UGRO"	F
"UHAL"	F
"UHS"	T
"UHT"	F
"UI"	F
"UIS"	T
"UK"	F
"UL"	T
"ULBI"	F
"ULCC"	F
"ULH"	F
"ULTA"	T
"UMBF"	T
"UMC"	T
"UMH"	F
"UMPQ"	T
"UNF"	F
"UNFI"	T
"UNH"	T
"UNICY"	F
"UNIT"	T
"UNM"	T
"UNP"	T
"UNTC"	F
"UNTY"	F
"UNVR"	T
"UONEK"	F
"UOVEY"	F
"UP"	F
"UPC"	F
"UPLD"	F
"UPS"	T
"UPST"	F
"UPWK"	F
"UPXI"	F
"URBN"	T
"URC"	F
"URE"	T
"URG"	F
"URGN"	F
"URI"	T
"USAC"	T
"USAU"	F
"USB"	T
"USCB"	F
"USCT"	F
"USDP"	T
"USEA"	F
"USEG"	F
"USER"	F
"USFD"	T
"USIO"	F
"USM"	T
"USNA"	F
"USPH"	F
"USX"	F
"UTAA"	F
"UTHR"	T
"UTI"	T
"UTL"	F
"UTME"	F
"UTZ"	F
"UUGRY"	F
"UVE"	T
"UVSP"	F
"UVV"	T
"UWMC"	F
"UXIN"	F
"V"	T
"VAC"	T
"VACC"	F
"VAL"	T
"VALE"	T
"VANI"	F
"VAQC"	F
"VATE"	F
"VAXX"	F
"VBOC"	F
"VBTX"	F
"VC"	T
"VCEL"	T
"VCSA"	F
"VCTR"	F
"VCV"	F
"VCXB"	F
"VCYT"	T
"VECO"	T
"VEEE"	F
"VEEV"	T
"VELO"	F
"VENA"	F
"VEOEY"	F
"VERA"	F
"VERI"	F
"VERU"	F
"VERV"	F
"VERX"	F
"VET"	T
"VFC"	T
"VFF"	F
"VGM"	F
"VGR"	T
"VHAQ"	F
"VHC"	T
"VHI"	F
"VIA"	F
"VIAO"	F
"VIAV"	T
"VICI"	F
"VICR"	T
"VIEW"	F
"VIGL"	F
"VIHDD"	F
"VII"	F
"VINO"	F
"VINP"	F
"VIPS"	T
"VIR"	F
"VIRT"	T
"VIRX"	F
"VITL"	F
"VIV"	T
"VIVHY"	F
"VIVO"	T
"VJET"	T
"VKTX"	F
"VLAT"	F
"VLCN"	F
"VLD"	F
"VLDR"	F
"VLGEA"	F
"VLN"	F
"VLO"	T
"VLRS"	T
"VLY"	T
"VMC"	T
"VMD"	F
"VMEO"	F
"VMGA"	F
"VMI"	T
"VMW"	T
"VNDA"	T
"VNET"	T
"VNO"	T
"VNOM"	T
"VNRX"	F
"VNT"	F
"VOC"	T
"VOD"	T
"VOR"	F
"VORB"	F
"VOX"	T
"VOXX"	T
"VOYA"	T
"VPG"	T
"VRA"	T
"VRAR"	F
"VRAX"	F
"VRAY"	F
"VRCA"	F
"VRDN"	F
"VRE"	F
"VREX"	T
"VRM"	F
"VRME"	F
"VRNA"	F
"VRNS"	F
"VRNT"	T
"VRRM"	F
"VRSK"	T
"VRSN"	T
"VRT"	F
"VRTS"	F
"VRTV"	T
"VRTX"	T
"VS"	F
"VSAT"	T
"VSCO"	F
"VSEC"	F
"VSH"	T
"VST"	F
"VSTA"	F
"VSTO"	T
"VTDRF"	F
"VTEX"	F
"VTIQ"	F
"VTNR"	T
"VTOL"	F
"VTR"	T
"VTRS"	F
"VTRU"	F
"VTSI"	F
"VTYX"	F
"VUZI"	T
"VVI"	F
"VVNT"	F
"VVV"	T
"VWE"	F
"VXRT"	F
"VYGR"	F
"VYNT"	F
"VZ"	T
"VZIO"	F
"VZLA"	F
"W"	T
"WAB"	T
"WABC"	T
"WAFD"	T
"WAFU"	F
"WAL"	T
"WASH"	F
"WAT"	T
"WATT"	T
"WAVC"	F
"WB"	T
"WBA"	T
"WBD"	F
"WBRBY"	F
"WBS"	T
"WBX"	F
"WCC"	T
"WCN"	T
"WD"	T
"WDAY"	T
"WDC"	T
"WDFC"	F
"WDH"	F
"WE"	F
"WEAV"	F
"WEBR"	F
"WEC"	T
"WEDXF"	F
"WEED"	F
"WELL"	F
"WEN"	T
"WERN"	T
"WES"	T
"WEST"	F
"WETG"	F
"WEX"	F
"WEYS"	F
"WF"	F
"WFC"	T
"WFCF"	F
"WFG"	F
"WFRD"	F
"WGO"	T
"WH"	F
"WHD"	F
"WHG"	F
"WHLR"	F
"WHR"	T
"WINA"	F
"WING"	T
"WINV"	F
"WIRE"	T
"WIT"	T
"WIX"	T
"WK"	T
"WKEY"	F
"WKHS"	F
"WKME"	F
"WKSP"	F
"WLDN"	F
"WLFC"	F
"WLK"	T
"WLKP"	T
"WLMS"	F
"WLY"	F
"WM"	T
"WMB"	T
"WMC"	T
"WMG"	F
"WMK"	F
"WMMVY"	F
"WMPN"	F
"WMS"	T
"WMT"	T
"WNC"	T
"WNDW"	F
"WNEB"	F
"WNNR"	F
"WNS"	F
"WNW"	F
"WOLF"	F
"WOOF"	T
"WOR"	T
"WOW"	F
"WPC"	T
"WPCA"	F
"WPCB"	F
"WPM"	F
"WPP"	F
"WQGA"	F
"WRAC"	F
"WRAP"	F
"WRB"	F
"WRBY"	F
"WRK"	T
"WRLD"	T
"WRN"	F
"WSBC"	F
"WSBF"	T
"WSC"	F
"WSFS"	F
"WSM"	T
"WSO"	T
"WSR"	T
"WST"	F
"WT"	F
"WTBA"	F
"WTFC"	T
"WTI"	T
"WTM"	F
"WTRG"	F
"WTS"	T
"WTT"	F
"WTTR"	F
"WTW"	T
"WU"	T
"WVE"	F
"WW"	F
"WWAC"	F
"WWD"	T
"WWE"	T
"WWR"	F
"WWW"	T
"WY"	T
"WYNN"	T
"WYY"	F
"X"	T
"XAIR"	F
"XBIT"	T
"XCUR"	F
"XEL"	T
"XENE"	F
"XERS"	F
"XFIN"	F
"XFOR"	F
"XGN"	F
"XHR"	T
"XLO"	F
"XM"	F
"XMTR"	F
"XNCR"	T
"XNET"	T
"XOM"	T
"XOMA"	F
"XP"	F
"XPAX"	F
"XPDB"	F
"XPEL"	F
"XPER"	T
"XPEV"	F
"XPO"	T
"XPOF"	F
"XPON"	F
"XPRO"	F
"XRAY"	T
"XRX"	T
"XXII"	T
"XYF"	F
"XYL"	T
"YALA"	F
"YELL"	F
"YELP"	T
"YETI"	F
"YEXT"	F
"YGMZ"	F
"YI"	F
"YMAB"	F
"YMM"	F
"YMTX"	F
"YORW"	F
"YOSH"	F
"YOU"	F
"YPF"	T
"YQ"	F
"YRD"	T
"YRI"	F
"YSG"	F
"YTEN"	F
"YTPG"	F
"YTRA"	F
"YUM"	T
"YUMC"	T
"YY"	T
"ZBH"	T
"ZBRA"	T
"ZCMD"	F
"ZD"	F
"ZDGE"	F
"ZEN"	T
"ZENV"	F
"ZEPP"	F
"ZETA"	F
"ZEUS"	T
"ZFOX"	F
"ZG"	T
"ZGN"	F
"ZH"	F
"ZI"	F
"ZIM"	F
"ZIMV"	F
"ZING"	F
"ZION"	T
"ZIP"	F
"ZLAB"	F
"ZM"	F
"ZNTL"	F
"ZS"	F
"ZT"	F
"ZTO"	T
"ZTR"	F
"ZTS"	T
"ZUMZ"	T
"ZUO"	F
"ZURVY"	F
"ZVIA"	F
"ZWRK"	F
"ZWS"	F
"ZYME"	F
"ZYXI"	F
